a	[叹][名]
a si	[状]
a ta	[状]
axxabumbi	[及]
axxalambi	[不及]
axxambi	[不及]
axxan	[名]
axxandumbi	[及]
axa	[名]
axumbumbi	[及]
aba	[名][方]
abalabumbi	[及]
abalambi	[不及]
abalanambi	[不及]
abalandumbi	[不及]
abalanjimbi	[不及]
abalanumbi	[不及]
abdaha	[名]
abdahanambi	[不及]
abdangga	[形]
abdari	[名]
abgari	[形]
abixaha dabixaha	[形]
abida	[名]
abide	[副]
abimbi	[不及]
abka	[叹][名]
abkana	[名]
absa	[名]
absalan	[名]
absambi	[不及]
absi	[副]
abtajambi	[不及]
abtalabumbi	[及]
abtalambi	[及]
abtarambi	[不及]
abtukvlambi	[不及]
abu	[副]
abuci	[名]
abuha	[名]
abulimbi	[不及]
abuna	[名]
aburambi	[不及]
aburanambi	[不及]
aburi	[形]
acabun	[名]
acabungga	[形]
acalambi	[不及]
acamjabumbi	[及]
acamjambi	[不及]
acamjangga	[形]
acan	[名]
acanambi	[不及]
acandumbi	[不及]
acangga	[名]
acanjimbi	[不及]
acanumbi	[不及]
acibumbi	[及]
aciha	[名]
acihi	[名]
acihilabumbi	[及]
acihilambi	[不及]
acilambi	[不及]
acimbi	[及][不及]
acin	[名]
acindumbi	[不及]
acinggiyabumbi	[及]
acinggiyambi	[及]
acinggiyan	[名]
acu	[叹]
acu acu	[副]
acu facu	[副][状]
acuhvn	[名]
acuhiyadambi	[不及]
acuhiyan	[名]
acun	[名]
ada	[名]
adabumbi	[及]
adada	[叹]
adada ebebe	[状]
adage	[名]
adaha	[名]
adaki	[形]
adali	[形][后]
adalixambi	[不及]
adalikan	[形]
adaliliyan	[形]
adalingga	[形]
adanambi	[不及]
adanumbi	[不及]
adarame	[副]
adasun	[名]
adu	[名]
aduci	[名]
aduhi	[名]
adulabumbi	[及]
adulambi	[及]
adun	[名]
adunggiyambi	[不及]
adurambi	[不及]
afabubumbi	[不及]
afabumbi	[不及]
afaha	[名]
afahanambi	[不及]
afahari	[名]
afahasi	[名]
afakv	[名]
afakiyambi	[不及]
afambi	[及]
afan	[名]
afanambi	[及]
afandumbi	[不及]
afanggala	[副]
afanjimbi	[不及]
afanumbi	[不及]
afatambi	[不及]
afin	[名]
afiya	[名]
agvra	[名]
aga	[名]
agabusba	[名]
agada	[名]
agambi	[不及]
agangga	[形]
age	[名]
ageli	[名]
agu	[名]
agulabumbi	[及]
ahvxambi	[及]
ahvcilabumbi	[及]
ahvcilambi	[不及]
ahvlabumbi	[及]
ahvlambi	[不及]
ahvn	[名]
ahvngga	[形]
ahvrambi	[不及]
ahvri hvyari	[状]
aha	[名]
ahada	[名]
ahadan	[名]
ahalakci	[名]
ahantumbi	[不及]
ahita	[形]
ai	[叹][代][小]
ai gung	[名]
ai maka	[叹]
ai wei	[状]
aibi	[代]
aibimbi	[不及]
aibingge	[形]
aibishvn	[形]
aici	[代][副]
aidagan	[名]
aidahaxambi	[不及]
aidahan	[名]
aifini	[副]
aifumbi	[及]
aigan	[名]
aihv	[名]
aihvju	[名]
aihvma	[名]
aihvme	[名]
aihvn	[名]
aiha	[名]
aihadambi	[不及]
aihaji	[名]
aihana	[名]
aihanaha	[名]
aihanambi	[不及]
aihu	[名]
aijirgan	[名]
aika	[代][连][副]
aikabade	[连]
aikan	[名]
aikanambi	[不及]
aili	[名]
ailimbi	[不及]
ailinambi	[不及]
ailungga	[形]
aimaka	[连]
aiman	[名]
aimika	[名]
ainahai	[副]
ainambahambi	[不及]
ainame	[副]
ainci	[副]
aini	[副]
ainu	[代]
aise	[小]
aisembi	[及]
aiseme	[副]
aisha	[形]
aisi	[名]
aisilabukv	[名]
aisilakv	[名]
aisilambi	[不及]
aisilan	[名]
aisilandumbi	[不及]
aisilangga	[名]
aisilanumbi	[不及]
aisilatambi	[不及]
aisimbi	[不及]
aisimu	[名]
aisin	[名]
aisingga	[形]
aisirgan	[名]
aisiri	[形]
aisuri	[名]
aitubun	[名]
aitubungga	[形]
aitubungga maksin	[形]
aitumbi	[不及]
aiturelambi	[不及]
aituri	[名]
aiyongga	[形]
aja	[名]
ajabumbi	[不及]
ajaja	[叹]
ajambi	[及]
aji	[形]
ajida	[形]
ajigan	[名]
ajige	[形]
ajigen	[形]
ajigesi	[形]
ajihen	[形]
ajilabumbi	[及]
ajilambi	[及]
ajin	[名]
ajirgalambi	[不及]
ajirgan	[形]
ajirhalambi	[不及]
ajirhan	[名]
ajirka	[及]
ajisi	[名]
ak	[叹]
akv	[名]
akv oci	[连]
akvci	[连]
akvhangge	[名]
akvmbi	[不及]
akvmbumbi	[及]
akvmi	[名]
akvn	[名]
akvnambi	[不及]
akvngge	[形]
akvnjimbi	[不及]
akxambi	[不及]
akxan	[名]
akxulambi	[不及]
akxun	[名]
aka	[名]
akabumbi	[及]
akacuka	[副]
akacun	[名]
akambi	[不及]
akcubi	[名]
akdabumbi	[及]
akdacuka	[形]
akdacun	[名]
akdan	[名]
akdandumbi	[不及]
akdukan	[形]
akdulabumbi	[及]
akdulandumbi	[不及]
akdulanumbi	[不及]
akdun	[名]
akdungga	[形]
ake	[叹]
akiran	[名]
akiya	[名]
akiyambi	[不及]
akiyan	[名]
akjaba	[名]
akjambi	[不及]
akjambulu	[名]
akjan	[名]
akjandambi	[不及]
akjuhiyan	[形]
aksabumbi	[不及]
aksalambi	[不及]
aksambi	[不及]
aksambumbi	[不及]
aksargan	[名]
akta	[名]
aktalabumbi	[及]
aktalakv	[名]
aktalambi	[不及]
aktaliyan	[名]
ala	[名]
alaxan	[名]
alabumbi	[不及]
alajan	[名]
alakdaha	[名]
alakdahan	[名]
alambi	[及][不及]
alamibumbi	[及]
alamimbi	[及]
alan	[名]
alanabumbi	[及]
alanambi	[不及]
alandumbi	[不及]
alanggibumbi	[及]
alanggimbi	[及]
alanjimbi	[不及]
alanumbi	[不及]
alarame	[副]
alari	[形]
albabun	[名]
albalambi	[及]
alban	[名]
albasi	[名]
albatu	[形]
albatukan	[形]
albatulambi	[不及]
alcu	[名]
alcuka	[名]
alda	[名]
aldahi	[名]
aldakv	[名]
aldaka	[名]
aldangga	[形]
aldanggakan	[形]
aldarambi	[不及]
aldasi	[方]
aldasilambi	[不及]
aldungga	[形]
algan	[名]
algixambi	[不及]
algidambi	[及]
algimbi	[不及]
algimbumbi	[及]
algin	[名]
algindambi	[不及]
algingga	[形]
algintu	[名]
algiyabumbi	[不及]
algiyambi	[不及]
alhvdabumbi	[及]
alhvdambi	[及]
alhvdan	[名]
alhvdanumbi	[不及]
alhvji	[名]
alhvwa	[名]
alha	[形]
alhabumbi	[及]
alhacan	[名]
alhambi	[不及]
alhangga	[形]
alhari	[形]
alhata	[形]
alhatanambi	[不及]
alhatu	[形]
alhuru	[形]
alixabumbi	[及]
alixacuka	[形]
alixambi	[不及]
alixatambi	[不及]
alibun	[名]
alibunjimbi	[及]
aligan	[名]
alihan	[名]
alihantu	[名]
alikv	[名]
alikvlambi	[不及]
alikiyari	[名]
alimbaharakv	[副]
alin	[名]
alintu	[名]
alioi	[名]
alirame	[副]
alisun	[名]
alitun	[名]
aliyabumbi	[及]
aliyacun	[名]
aliyakiyambi	[不及]
aliyambi	[及]
aliyan	[名]
aliyasungga	[形]
aljambi	[不及]
alkvn	[名]
almin	[形]
alun	[形]
ama	[名]
amaga	[形]
amagangga	[形]
amaha	[名]
amaka	[名]
amala	[方]
amargi	[方]
amargingge	[形]
amarimbi	[不及]
amasi	[副]
amasikan	[形]
amba	[形]
ambakaliyan	[形]
ambakan	[形]
ambakasi	[形]
ambaki	[形]
ambakilambi	[不及]
ambalinggv	[形]
amban	[名]
ambarabumbi	[及]
ambarambi	[不及]
ambarame	[副]
ambasa	[名]
ambu	[名]
ambuhai	[形]
ambula	[副]
ambuma	[名]
ambumbi	[不及]
amcadambi	[及]
amcakvxambi	[不及]
amcanambi	[不及]
amcangga	[形]
amcanjimbi	[不及]
amcatambi	[及]
amda	[形]
amdulabumbi	[及]
amdulambi	[及]
amdun	[名]
amga	[形][名]
amgabumbi	[及]
amgacambi	[不及]
amgambi	[不及]
amganambi	[不及]
amgangga	[形]
amhvlan	[名]
amha	[名]
amhabumbi	[及]
amhacambi	[不及]
amhambi	[不及]
amhan	[名]
amhanambi	[不及]
amixaka	[形]
amida	[名]
amihvn	[名]
amila	[形]
amilambi	[不及]
amin	[名]
amji	[名]
amsu	[名]
amsulambi	[不及]
amsun	[名]
amtaxambi	[及]
amtalambi	[不及]
amtan	[名]
amtangga	[形]
amtanggai	[副]
amtun	[名]
amu 	[名]
amu	[名]
amuxabumbi	[不及]
amuran	[名]
amurangga	[形]
amurgan	[名]
amurtu	[形]
an	[名]
an hvi	[名]
anacaxi	[名]
anada bindadi yafan	[名]
anafu	[名]
anafulabumbi	[及]
anafulambi	[不及]
anagan	[名]
anahvn	[名]
anahvngga	[形]
anahvnjambi	[不及]
anahvnjan	[名]
anahvnjangga	[形]
anahan	[名]
anakv	[名]
aname	[后][副]
anameliyan	[形]
anami	[名]
anan	[名]
ananda	[名]
anashvn	[名]
anatanumbi	[不及]
ancu	[名]
anculakv	[名]
anculan	[名]
ancun	[名]
anda	[名][副]
andala	[名]
andan	[名]
andande	[副]
andarxambi	[不及]
andarambi	[不及]
andargi	[名]
andarki	[形]
andasi	[副]
andubumbi	[及]
anduhvri	[形]
anduhvrilambi	[不及]
anfan	[名]
anfu	[名]
anfulambi	[及]
ang	[状]
anggvta	[名]
angga	[名]
anggakv	[名]
anggala	[名][连]
anggalambi	[不及]
anggalinggv	[名]
anggara	[名]
anggari	[名][副]
anggasi	[形]
anggasibumbi	[及]
anggasilambi	[不及]
anggasimbi	[及]
anggatu	[名]
anggi	[名]
anggir	[名]
anggiyan	[名]
aniruda	[名]
aniya	[名]
aniyaingge	[名]
aniyalame	[副]
aniyangga	[名]
anja	[名]
anji	[名]
anjibumbi	[及]
anjikv	[名]
anjimbi	[及]
anju	[名]
anta	[代]
antaha	[名]
antahaxambi	[不及]
antahalambi	[不及]
antaharambi	[不及]
antahasi	[名]
antai	[代]
antaka	[代]
antaraha ? 	[名]
antu	[名]
antuhvri	[形]
antuhvrilambi	[及]
anwan	[名]
ar	[状]
arxan	[名]
arxu	[名]
ara	[叹][名]
ara fara	[状]
araxan	[名]
arabumbi	[及]
arambi	[及]
arandumbi	[及]
aranumbi	[及]
arbuxambi	[不及]
arbuxarangge	[名]
arbun	[名]
arbungga	[形]
arca	[名]
arcambi	[及]
arcan	[名]
arcilan	[名]
arda	[名]
ardashvn	[形]
are	[叹]
arfa	[名]
arfukv	[名]
argvma	[形]
arga	[名]
argabumbi	[及]
argacan	[名]
argadambi	[不及]
argali	[名]
argambi	[及]
argan	[名]
arganacambi	[不及]
arganambi	[不及]
argangga	[形]
argat	[名]
argatu	[名]
argiyambi	[及]
arhangga	[形]
ari	[名]
arjan	[名]
arkan	[副]
arke	[叹]
arki	[名]
arsalan	[名]
arsari	[形]
arsaringge	[名]
arsubumbi	[及]
arsumbi	[不及]
arsun	[名]
artabumbi	[不及]
artu	[名]
aru	[方]
arun	[名]
asaha	[副]
asanggi galpa	[名]
asarabumbi	[及]
asarambi	[及]
asari	[名]
ashvn	[名]
asha	[名]
ashabukv	[名]
ashabumbi	[及]
ashambi	[及]
ashan	[名]
ashanambi	[不及]
ashangga	[形]
ashargan	[名]
asi	[副]
asigan	[形]
asiha	[形]
asihaki	[形]
asihan	[形]
asihiyabumbi	[及]
asihiyambi	[及]
asikaliyan	[形]
asikan	[形]
asikasi	[形]
aska faska	[副]
asu	[名]
asuci	[名]
asuki	[名]
asukilabumbi	[及]
asukilambi	[不及]
asukingga	[形]
asumi	[名]
asurxambi	[不及]
asuru	[副]
atahasi	[名]
atan	[名]
atanggi	[副]
ataracambi	[不及]
atarambi	[不及]
atmula	[名]
atu	[名]
atuhvn	[名]
atuha	[名]
aya	[叹]
ayalambi	[不及]
ayambi	[不及]
ayan	[形][名]
ayantumbi	[不及]
ayao	[小]
ayara	[名]
ayari	[名]
ayoo	[小]
ayusi	[名]
bvrtu	[名]
ba	[名]
ba wang	[名]
baxa	[名]
baxambi	[及]
baxilambi	[及]
babi	[副]
babuxan	[名]
babuhan	[名]
babun	[名]
babungga	[形]
bacihi	[名]
bacihilambi	[不及]
bada	[名]
badalambi	[不及]
badar	[状]
badarambi	[不及]
badarambumbi	[及]
badarambungga	[形]
badaran	[名]
badarangga doro	[名]
bade	[连]
badiri	[名]
badun	[名]
bagiyambi	[不及]
bagula	[名]
baha	[名]
bahambi	[及]
bahana	[名]
bahanambi	[及]
bahanasi	[名]
bahanggala	[副]
bahangge	[名]
bahanjimbi	[不及]
bahiya	[名]
bai	[小][副]
baibi	[副]
baibingge	[名]
baibula	[名]
baibulan	[名]
baibumbi	[及]
baiburengge	[名]
baicabumbi	[及]
baicambi	[及]
baicanabumbi	[及]
baicanambi	[及]
baicandumbi	[及]
baicanjimbi	[及]
baicanumbi	[及]
baicasi	[名]
baidalambi	[不及]
baidambi	[及]
baidumbi	[及]
baihabumbi	[及]
baihanabumbi	[及]
baihanambi	[不及]
baihanjimbi	[不及]
baikv	[名]
baili	[名]
bailingga	[形]
bailisi	[名]
baimbi	[及]
baime	[后]
bainambi	[及]
baindumbi	[不及]
baingge	[形]
bainjimbi	[及]
bainumbi	[不及]
baise	[名]
baisin	[形]
baita	[名]
baitakv	[形]
baitakvngge	[名]
baitalabumbi	[及]
baitalambi	[及]
baitalan	[名]
baitalarangge	[形]
baitangga	[形]
baitanggangge	[名]
baitasi	[名]
bajar	[状]
bajargi	[方]
baji	[副]
bajikan	[副]
bajila	[方]
bajima	[副]
bajimashvn	[形]
baju	[名]
bakalaji	[名]
bakalji	[名]
bakcilambi	[不及]
bakcilame	[后]
bakcilandumbi	[不及]
bakcin	[名]
bakja	[状]
bakjabumbi	[及]
bakjakan	[形]
bakjalambi	[不及]
bakjambi	[不及]
baksalabumbi	[及]
baksalambi	[不及]
baksan	[名]
baksanda	[名]
baksangga	[形][名]
baksatu	[名]
baksi	[名]
baktakv	[名]
baktambi	[不及]
baktambumbi	[及]
baktambun	[名]
baktan	[名]
baktandambi	[不及]
baktangga	[形]
balai	[形][副]
balakta	[名]
balama	[形][副]
balamadambi	[不及]
balba	[名]
balda	[名]
baldargan	[名]
baldarhan	[名]
baldasitambi	[不及]
baleni	[形]
balhambi	[不及]
baliya	[叹][小]
baljun	[名]
balta	[名]
baltaha	[名]
balu	[形]
bambi	[及]
ban hiya	[名]
banajan	[名]
banaje	[名]
banaji	[名]
banasi	[名]
banatambumbi	[不及]
bancuka	[形]
banda	[名]
bandambi	[不及]
bandan	[名]
bando	[名]
bang	[名]
bangguhe	[名]
bangse	[名]
bangtu	[名]
banihvn	[形]
banihvnjambi	[及]
baniha	[名]
banihalambi	[不及]
banilambi	[不及]
banimbi	[不及]
banin	[名]
baninambi	[不及]
baningga	[形]
banirke	[形]
banitai	[名][副]
banitaingge	[形]
banjanumbi	[不及]
banji	[名]
banjibumbi	[及]
banjibun	[名]
banjibungga	[形]
banjicuka	[形]
banjihangge	[名]
banjimbi	[不及]
banjime	[名]
banjin	[名]
banjinabumbi	[及]
banjinambi	[不及]
banjindumbi	[不及]
banjinjimbi	[不及]
banjinumbi	[不及]
banjirengge	[名]
banjirke	[形]
banjishvn	[形]
banjitai	[名]
banuhvxambi	[不及]
banuhvn	[形]
bar bar	[状]
bar bir	[状]
bar kul	[名]
barambi	[不及]
baramida	[名]
baramit	[名]
baran	[名]
baran weji	[名]
baranggalanda	[名]
baranza	[名]
barbehe	[名]
barda	[名]
bardanggi	[名]
bardanggilambi	[不及]
bargiyabumbi	[及]
bargiyakv	[名]
bargiyambi	[及]
bargiyan	[名]
bargiyantu	[名]
bargiyaralambi	[及]
bargiyashvn	[形]
barkiyambi	[及]
bartanambi	[不及]
baru	[后]
barun	[名]
basa	[名]
basan	[名]
basangiyambi	[及]
basucun	[形]
basugiyambi	[及]
basumbi	[及]
basunggiyambi	[不及]
basunumbi	[及]
bata	[名]
batak	[状]
batalabumbi	[及]
batalambi	[不及]
batangga	[形]
batkalambi	[及]
batmaga	[名]
batu	[形]
batun	[名]
baturu	[形]
baturulambi	[不及]
baturungga	[形]
bayabumbi	[及]
bayambi	[不及]
bayambumbi	[及]
bayan	[形]
bayandambi	[不及]
bayara	[名]
bayartu	[名]
bazung	[名]
be	[代][名][小]
be hiyan	[名]
be liyan	[名]
bexehun	[形]
bexembi	[及]
bexembumbi	[及]
bebeliyembi	[不及]
beberembi	[不及]
bebu	[状]
bebuxembi	[不及]
becembi	[及]
becen	[名]
becendumbi	[不及]
beciyan	[名]
becumbi	[不及]
becun	[名]
becunembi	[不及]
becuntu	[名]
becuntungge	[形]
becunubumbi	[及]
becunumbi	[不及]
bedercebumbi	[及]
bederceku	[名]
bedercembi	[不及]
bederebumbi	[及]
bederecembi	[不及]
bederembi	[不及]
bederi	[名]
bederinembi	[不及]
bederingge	[形]
bedu	[名]
bedun	[形]
bedune	[名]
beging	[名]
begu	[名]
beguo	[名]
behe	[名]
behelebumbi	[及]
behelembi	[不及]
bei	[名]
bei ioi	[名]
bei ye	[名]
beibun	[名]
beidembi	[不及]
beiden	[名]
beidesi	[名]
beiduri	[名]
beiguwan	[名]
beiguwe	[名]
beiguwen	[形]
beiguwerembi	[不及]
beihe	[名]
beihuwe	[名]
beikuwen	[形]
beikuwerembi	[不及]
beile	[名]
beileci	[名]
beilecilembi	[不及]
beilecinembi	[不及]
beise	[名]
beje	[名]
beji	[名]
bejihiyebumbi	[及]
bejihiyembi	[不及]
bejilembi	[不及]
bejing	[名]
bekde bakda	[形]
bekderembi	[不及]
bekdun	[名]
beki	[形]
bekiken	[形]
bekilebumbi	[及]
bekilembi	[及]
bekin	[名]
bekitu	[形]
bekte bakta	[状]
bektelembi	[不及]
bekterebumbi	[不及]
bekterembi	[不及]
bektu	[名]
beku	[名]
belci	[名]
belcidembi	[不及]
belcitembi	[不及]
bele	[名]
belek	[名][状]
beleke	[名]
belembi	[及]
belemimbi	[及]
belendumbi	[不及]
beleningge	[形]
belge	[名]
belgeci	[名]
belgembi	[及][名]
belgenembi	[不及]
belgeri	[形]
belhebuku	[名]
belhebumbi	[及]
belhembi	[及]
belhen	[名]
belhendumbi	[及]
belhenembi	[及]
belhenjimbi	[及]
belhenumbi	[及]
belhesi	[名]
belhetu	[名]
beliyedembi	[不及]
beliyeken	[形]
beliyen	[形]
bemberembi	[不及]
ben	[名]
bencan	[名]
benciyan	[名]
benebumbi	[及]
benehengge	[名]
benembi	[及]
bengnebumbi	[及]
bengneli	[副]
bengnembi	[不及]
bengse	[名]
bengsen	[名]
bengsengge	[形]
benjibumbi	[及]
benjihengge	[名]
benjimbi	[及]
benjinembi	[不及]
beo	[小]
berebumbi	[及]
berembi	[不及]
beren	[名]
berge	[名]
bergelembi	[不及]
berhe	[名]
berhelembi	[及]
berhu	[名]
berhun	[名]
beri	[名]
beri beri	[形]
berileku	[名]
beringga	[形]
beringge	[形]
bertebumbi	[不及]
bertembi	[不及]
berten	[名]
bertenebumbi	[不及]
bertenembi	[不及]
beserei	[名]
besergen	[名]
beserhen	[名]
beseri	[名]
bete	[形]
beten	[名]
bethe	[名]
betheleku	[名]
bethelembi	[不及]
bethengge	[形]
beye	[代][名]
beyebumbi	[不及]
beyeingge	[代]
beyembi	[不及]
beyembumbi	[及]
beyen	[名]
bi	[代][不及]
bixuxambi	[及]
bixubumbi	[及]
bixukan	[形]
bixumbi	[及]
bixun	[名]
bixuri	[名]
bibumbi	[及]
bicibe	[连]
bidarana	[名]
bidarum	[名]
biduri	[名]
bigan	[名]
bigarambi	[不及]
bigatu	[形]
biha	[名]
bihan	[名]
bii	[名]
bijabumbi	[及]
bijambi	[及]
bikcu	[名]
bikcuni	[名]
bikita	[名]
bikjambi	[不及]
bila	[名]
bilabumbi	[及]
bilagan	[名]
bilambi	[及]
bilan	[名]
bilasi	[名]
bilcambi	[不及]
bilembi	[不及]
bilerhen	[名]
bileri	[名]
bilga	[名]
bilgacungga	[形]
bilgexembi	[不及]
bilgembi	[不及]
bilha	[名]
biljambi	[及]
biltembi	[不及]
bilten	[名]
biluxambi	[及]
bilubumbi	[及]
bilukv	[名]
bilukan	[形]
bilumbi	[及][不及]
bilun	[名]
bilungga	[形]
bilurjambi	[不及]
bilurjembi	[不及]
bimxu	[名]
bimbi	[不及]
bimbime	[连]
bime	[连]
bin lang	[名]
bin zy	[名]
bing biyang	[状]
bing piyan	[名]
binggiya	[名]
bingha	[名]
bingse	[名]
bingselembi	[不及]
bingsiku	[名]
binjala	[名]
bir	[状]
bira	[名]
biraman	[名]
birangga	[形]
birbin	[名]
birca	[名]
biregen	[名]
bireku	[名]
birembi	[及]
bireme	[副]
birendumbi	[及]
birenembi	[及]
biretei	[副]
birgan	[名]
birgexembi	[不及]
birhexembi	[不及]
bisambi	[不及]
bisan	[名]
bisantu	[名]
bisarambi	[不及]
bisari ilha	[名]
bisi	[名]
bisin	[名]
bisirele	[形]
bisirelengge	[形]
bisireltu	[形]
bisirengge	[形]
bita	[名]
bitele	[副]
bithe	[名]
bithelembi	[不及]
bithesi	[名]
bitubumbi	[及]
bitugan	[名]
bituhan	[名]
bitumbi	[及]
biturame	[后]
biwanggirt	[名]
biya	[名]
biyabiyahvn	[形]
biyabiyashvn	[形]
biyadar	[状]
biyahvn	[形]
biyaingge	[形]
biyalambi	[不及]
biyalanggi	[形]
biyalari	[形]
biyaldasitambi	[不及]
biyalumbi	[不及]
biyandu	[名]
biyangga	[形]
biyangge	[形]
biyanggidei	[名]
biyangsikv	[名]
biyangsiri	[形]
biyantaha	[名]
biyar	[状]
biyara	[名]
biyarambi	[不及]
biyargiyaxambi	[不及]
biyargiyan	[形]
biyarixambi	[不及]
biyarimbi	[及]
biyashvmbi	[不及]
biyatar	[状]
biyohalambi	[不及]
biyolokoxombi	[不及]
biyolombi	[及]
biyolumbi	[及]
biyombi	[及]
biyoo	[名]
biyooha	[名]
biyoohari	[形]
biyoolambi	[及]
biyoor	[状]
biyor	[状]
biyoran	[名]
biyorong	[状]
bo long gu	[名]
bo sy	[名]
bo yoi	[名]
boxokv	[名]
boxombi	[及]
boxondumbi	[及]
boxonjimbi	[及]
boxonombi	[及]
boxonumbi	[及]
boborxambi	[不及]
boborxombi	[不及]
boceri	[形]
bocihe	[形]
bocihi	[形]
boco	[名]
boconggvngge	[形]
boconggo	[形]
boconggongge	[形]
boda	[名]
bodi	[名]
bodisatu	[名]
bodise	[名]
bodisu	[名]
bodobumbi	[及]
bodogon	[名]
bodogonggo	[名]
bodohon	[名]
bodohonggo	[形]
bodokv	[名]
bodombi	[及]
bodomime	[副]
bodon	[名]
bodonggiyambi	[不及]
bodonggo	[名]
bodonombi	[及]
bodor	[状]
bodori	[名]
bofu	[名]
bofulabumbi	[及]
bofulambi	[及]
bofun	[名]
bohibumbi	[及]
bohikv	[名]
bohimbi	[及]
bohokon	[形]
bohomi	[名]
bohon	[形]
bohori	[名]
bohoto	[名]
boifuka	[名]
boigocilambi	[不及]
boigoji	[名]
boigojilambi	[不及]
boigon	[名]
boihocilambi	[不及]
boihoji	[名]
boihojilambi	[不及]
boihoju	[名]
boiholombi	[不及]
boihon	[名]
boingge	[名]
boisile	[名]
boisiri	[名]
boje	[名]
boji	[名]
bojilabumbi	[及]
bojilambi	[及]
bojina	[形]
bojiri	[名]
bokxokon	[形]
bokxolombi	[及]
bokxon	[名]
bokda	[名]
bokida	[名]
bokidangga	[形]
bokirashvn	[形]
bokirshvn	[形]
bokori	[名]
bokto	[名]
bolabumbi	[及]
bolambi	[不及]
bolanjimbi	[不及]
bolbonombi	[及]
bolgangga	[形]
bolgimbi	[不及]
bolgo	[形]
bolgobumbi	[及]
bolgokon	[形]
bolgombi	[不及]
bolgomi	[名]
bolgomimbi	[不及]
bolgon	[形]
bolgonggo	[形]
bolgosaka	[形]
bolgosu	[名]
bolho	[形]
bolhombi	[不及]
bolhomi	[名]
bolhomimbi	[不及]
bolhosu	[名]
boli	[名]
bolibumbi	[及]
bolikv	[名]
bolimbi	[及]
bolin	[名]
boljobumbi	[及]
boljohon	[名]
boljohongge	[形]
boljombi	[不及]
boljon	[名]
boljonggo	[形]
bolkosaka	[形]
bolohon	[形]
bolokon	[形]
bolombi	[不及]
bolori	[名]
bolorikten	[名]
bolosu	[名]
bombi	[及]
bombokon	[形]
bombonombi	[不及]
bombori	[名]
bombornombi	[不及]
bon	[名]
boncihiyan	[名]
bongcilihi	[名]
bonggibumbi	[及]
bonggimbi	[及]
bonggo	[形]
bonggonombi	[不及]
bongjonggi	[名]
bongkv	[名]
bongko	[名]
bongkon	[名]
bongkonombi	[不及]
bongsimu	[名]
bonio	[名]
bonionggo	[形]
bonitun	[名]
bono	[名]
bonombi	[不及]
bontoho	[名]
bontoholobumbi	[及]
bontoholombi	[不及]
boo	[名]
boo ciowan	[名]
boo yuwan	[名]
booxi	[名]
boobai	[名]
boofun	[名]
booha	[名]
boohalabumbi	[及]
boohalambi	[不及]
booingge	[名]
boolabumbi	[及]
boolambi	[及][不及]
boombi	[及]
boongga	[形]
boose	[名]
boosi	[名]
booze	[名]
borbo	[名]
borboki	[名]
borcilambi	[及]
bordobumbi	[及]
bordokv	[名]
bordombi	[及]
borhombi	[不及]
borhon	[名]
borhonombi	[不及]
borhoto	[名]
borimbi	[不及]
borinambi	[不及]
borjin	[形]
boro	[形][名]
boroko	[形]
borton	[形]
bortonombi	[不及]
bos	[名]
bose	[名]
boselambi	[及]
boshv	[名]
bosho	[名]
boshonggo	[形]
boso	[名]
bosoro	[名]
buxa	[形]
buxakan	[形]
buxubumbi	[不及]
buxuhvn	[形]
buxuku	[名]
buxukudembi	[不及]
buxukulembi	[不及]
bubu baba	[状]
bubumbi	[及]
buburxambi	[不及]
buburxembi	[不及]
buca	[名]
bucebumbi	[及]
bucehengge	[名]
buceli	[名]
bucembi	[不及]
buceshvn	[形]
bucetu	[名]
bucilebumbi	[及]
bucileku	[名]
bucilembi	[及]
buciliku	[名]
bucin	[名]
buculimbi	[及]
buda	[名]
budalambi	[不及]
budembi	[不及]
buderembi	[及]
buduhu	[名]
budukan	[形]
budulimbi	[不及]
budun	[形][名]
budurhvna	[名]
budurimbi	[及]
bufaliyambi	[不及]
bufuyen	[形]
bugv	[名]
buge	[名]
buhv	[名]
buha	[名]
buhatu	[名]
buhe	[形]
buheliyebumbi	[及]
buheliyembi	[及]
buheliyen	[名]
buhere	[名]
buhi	[名]
buhiyecuke	[形]
buhiyecun	[名]
buhiyembi	[不及]
buhiyembumbi	[不及]
buhiyen	[名]
buhiyendumbi	[不及]
buhiyenumbi	[不及]
bujabumbi	[及]
bujambi	[不及]
bujan	[名]
bujantu	[名]
bujekxembi	[不及]
bujengxi	[名]
bujihilambi	[不及]
buju baja	[形][数]
bujubumbi	[及]
bujuhengge	[名]
bujumbi	[及]
bujun	[数]
bujuri	[名]
bukvn	[名]
bukvri	[名]
buka	[名]
bukari	[名]
bukdaxambi	[及]
bukdalambi	[不及]
bukdambi	[及]
bukdambumbi	[及]
bukdan	[名]
bukdangga	[形]
bukdari	[名]
bukdarun	[名]
bukdashvn	[形]
bukdu bakda	[状]
bukduhun	[名]
bukirsuhvn	[形]
buksa	[状]
buksibumbi	[及]
buksimbi	[不及]
buksin	[名]
buksinambi	[不及]
buksindumbi	[不及]
buksinumbi	[不及]
buksu	[名]
buksuri	[形]
buksurilambi	[不及]
buktalambi	[不及]
buktalimbi	[不及]
buktambi	[不及]
buktan	[名]
buktu	[名]
buktulin	[名]
buku	[名]
bukulembi	[不及]
bula	[名]
bulaci	[名]
bulahan	[名]
bulambi	[及]
bulangga	[形]
bulari	[名]
bulca	[名]
bulcakv	[名]
bulcakvxambi	[不及]
bulcambi	[不及]
bulcandumbi	[不及]
bulcatambi	[不及]
bulcin	[形]
buldu	[名]
buldun	[名]
bulduri	[名]
buldurimbi	[不及]
bulehen	[名]
bulehengge	[形]
buleku	[名]
bulekuxebumbi	[及]
bulekuxembi	[不及]
bulen	[名]
bulentumbi	[不及]
buleri	[名]
bulga	[形]
bulgangga	[形]
bulgari	[副]
bulgiyambi	[及]
bulgiyembi	[及]
bulgiyen	[名]
bulhvmbi	[不及]
bulhvri	[形]
bulha	[名]
bulhacan	[名]
bulhari	[名]
buli butu	[状]
bulimbi	[不及]
buling	[状]
bulingjembi	[不及]
bulinjambi	[不及]
bulinjembi	[不及]
buliyambi	[及]
buljan	[名]
buljanambi	[不及]
bulji	[名]
buljin	[名]
bultahvn	[形]
bultahvri	[形]
bultari	[形]
bulturimbi	[不及]
bulukan	[形]
bulumbi	[及]
bulun	[名]
buluntumbi	[不及]
bumba	[名]
bumbi	[不及]
bumbuku	[名]
bumbuli	[名]
bunai	[数]
bunasu	[名]
buncuhvn	[形]
bung bung	[状]
bunggimbi	[不及]
bungjan	[名]
bungjanambi	[不及]
bungnabumbi	[不及]
bungnambi	[不及]
bunjiha	[名]
bur	[状]
buraxambi	[及]
burabumbi	[及]
buraki	[名]
burakixambi	[及]
burambi	[及]
buran taran	[副]
buranggiyambi	[及]
burbumbi	[不及]
burdebumbi	[及]
burdembi	[及]
burdenumbi	[及]
buren	[名]
burenembi	[不及]
burga	[名]
burgaxambi	[不及]
burgambumbi	[不及]
burgasu	[名]
burgatu	[名]
burgixambi	[不及]
burgibumbi	[及]
burgimbi	[不及]
burgin	[名][副]
burgin bargin	[形]
burgindumbi	[不及]
burginumbi	[不及]
burgiyelembi	[及]
burgiyen	[形][名]
burguxambi	[不及]
burha	[名]
burhambi	[及]
buribumbi	[及]
burimbi	[及]
burkimbi	[及]
burlambi	[不及]
burtei	[副]
burtuku	[名]
buru bara	[形]
buru butu	[形]
burubumbi	[不及]
buruhun	[形]
burulabumbi	[及]
burulambi	[不及]
burulandumbi	[不及]
burulanumbi	[不及]
burulu	[名]
burumbi	[不及]
burut	[名]
busajambi	[不及]
busalambi	[不及]
busanggiyambi	[不及]
buscambi	[不及]
buse	[名]
busehe	[名]
buserebumbi	[不及]
busereku	[名]
buserembi	[不及]
bushe	[名]
bushenembi	[不及]
busu busu	[形]
busubumbi	[不及]
busumda	[名]
butvn	[名]
butabumbi	[及]
butalin	[名]
butambi	[及]
butan halan	[叹]
butemji	[形]
buten	[名]
buterembi	[不及]
butereme	[后]
butha	[名]
buthaxabumbi	[及]
buthaxambi	[不及]
buthaxanambi	[不及]
buthambi	[不及]
buthasi	[名]
butu	[形]
butulebumbi	[及]
butulembi	[及]
butumbi	[不及]
butumji	[名]
butun	[名]
butur	[状]
buturi	[名]
buturinambi	[不及]
buya	[形]
buyakaxi	[形]
buyarambi	[不及]
buyarame	[形]
buyasi	[形]
buyecuke	[形]
buyecun	[名]
buyembi	[及]
buyen	[名]
buyendumbi	[不及]
buyenin	[名]
buyenumbi	[不及]
buyerxembi	[及]
buyerengge	[名]
buyeri	[名]
cvn	[名]
cvn xa	[及]
ca	[名]
cab	[名]
cabagan	[形]
cabdara	[形][名]
cabdari	[形]
cabgan	[形]
cabi	[名]
cabihan	[名]
cabsimbi	[及]
cacarakv	[名]
cacari	[名]
cacumbi	[及]
cacurambi	[及]
cacurembi	[及]
cadabumbi	[及]
cadambi	[及]
cafur cifur	[状]
cagaci	[名]
cagan	[形][名]
cagatu	[形]
cahv	[名]
cahvxambi	[不及]
cahvdambi	[不及]
cahar	[名]
cahara	[名]
caharnambi	[不及]
cahin	[名]
cai	[名]
caida	[名]
caidu	[名]
caifung	[名]
caise	[名]
cak	[状]
cakv	[形]
cakvha	[名]
cakvlu	[形]
cakvlun	[名]
cakvlutu	[形]
cakvnaha	[名]
cakvran	[名]
cakvri	[形]
cakcahvn	[形]
cakcin	[数]
cakilgatu	[名]
cakiri	[形]
cakjambi	[不及]
caksaha	[名]
caksambi	[及]
caksikv	[名]
caksimbi	[不及]
cala	[名][方][后]
calabun	[名]
calahari	[形]
calambi	[不及]
calanambi	[不及]
calcin	[名]
calfa	[名]
calgabun	[名]
calgari	[形]
calgibumbi	[不及]
calgimbi	[及]
calgin	[名]
calhari	[形]
calihvn	[名]
calimbi	[不及]
caliyan	[名]
caliyangga	[形]
caliyasi	[名]
calkon	[形]
calmahvn	[名]
calmari	[形]
calu	[名]
calungga	[名]
camangga	[形]
camanggadambi	[不及]
cambi	[及]
camci	[名]
camda	[名]
camgan	[名]
camhan	[名]
camhari	[名]
camhata	[形]
camnambi	[及]
camsi	[名]
camtumbi	[不及]
can	[名]
can nimaha	[名]
canambi	[及]
cananggi	[名]
cang	[名][状]
cangga	[名]
canggali	[形]
canggalimbi	[不及]
canggi	[后][小][副]
cangka	[形]
cangkai	[副]
cangkambi	[及]
cangkir	[形]
cangmi	[名]
canjeng	[名]
canjiyang	[名]
canjurabumbi	[及]
canjurambi	[不及]
cao	[状]
car	[状]
cara	[形][名]
caranambi	[不及]
carcan	[状]
carcanambi	[不及]
carcinambi	[不及]
cargi	[形][方]
cargilakv	[名]
cargimbi	[及]
cargingge	[方]
carki	[名]
carkidambi	[及]
carkimbi	[不及]
carnambi	[不及]
carubumbi	[及]
carumbi	[及]
carur	[状]
cas	[状]
case	[名]
cashvlabumbi	[及]
cashvlambi	[及]
cashvn	[方]
casi	[副]
casiba	[名]
casikan	[方]
cata	[数]
ce	[代][名]
cebke	[名]
cebke cabka	[形]
cece	[名]
cecen	[名]
cecerxambi	[不及]
cecerxembi	[不及]
cecercuke	[形]
cecerembi	[及]
ceceri	[名]
cecike	[名]
cecikelembi	[不及]
cecikengge	[形]
cehede	[名]
cehun	[名]
cejehen	[名]
cejeleku	[名]
cejen	[名]
cekcerembi	[不及]
cekceri	[名]
ceke	[名]
cekemu	[名]
cekjehun	[形]
ceku	[名]
cekudembi	[及]
cekulembi	[及]
celebumbi	[及][不及]
celehen	[名]
celeku	[名]
celembi	[及][不及]
celheri	[名]
celin	[名]
celmen	[名]
celmeri	[形]
celmeringge	[形]
celmerjembi	[及]
cen	[名]
cen hiyang	[名]
cen ze	[名]
cendeku	[名]
cendekuxembi	[及]
cendembi	[及]
cendendumbi	[不及]
cendenumbi	[不及]
cene	[名]
cengme	[名]
cengmu	[名]
cengsiyang	[名]
ceningge	[名]
cense	[名]
cerguwe	[名]
cerhuwenembi	[不及]
ceri	[名]
ceringge	[形]
cese	[名]
ci	[名]
cib	[状]
cibahanci	[名]
cibargan	[名]
cibiha	[名]
cibin	[名]
cibingga	[形]
cibirgan	[名]
cibiri	[形]
cibsembi	[不及]
cibsen	[名]
cibsidambi	[不及]
cibsimbi	[不及]
cibsin	[名]
cibsindumbi	[不及]
cibsinumbi	[不及]
cibsonggo	[形]
cibtui	[副]
cibumbi	[及]
cici goci	[形]
cicigar	[名]
cicihar	[名]
cifabumbi	[及]
cifahan	[名]
cifahangga	[形]
cifambi	[及]
cifeleku	[名]
cifelembi	[不及]
cifenggu	[名]
cifun	[名]
cifuri	[形]
cigu	[名]
ciha	[后]
cihai	[后][副]
cihakv	[名]
cihakvliyan	[副]
cihakvngge	[名]
cihalxambi	[及]
cihalambi	[及]
cihalan	[名]
cihan	[名]
cihana	[后]
cihangga	[形]
cihanggai	[副]
cihe	[名]
cihetei	[名]
cihin	[名]
cik	[名][状]
cikexembi	[不及]
cikeku	[名]
cikimbi	[不及]
cikin	[名]
cikingge	[形]
cikirxambi	[不及]
cikirambi	[及]
cikirhv	[名]
cikiri	[形][名]
cikiringge	[形]
cikjalambi	[不及]
ciksimbi	[不及]
ciksin	[形]
ciktan	[名]
ciktarambi	[不及]
cikten	[名]
ciktenembi	[不及]
cikteneme	[副]
ciktengge	[形]
cilba	[名]
cilbambi	[不及]
cilburi	[名]
cilci	[名]
cilcilambi	[不及]
cilcimbi	[不及]
cilcin	[名]
cilcinambi	[不及]
cilembi	[及]
cilikv	[名]
cilimbi	[不及]
cimaha	[名]
cimari	[名]
cimarilambi	[不及]
cimarilame	[副]
cimcimbi	[及]
cime	[名]
cimeke	[名]
cimikv	[名]
cimilan	[名]
cimkixambi	[不及]
cimkixamiyeliyan	[形]
cimkixembi	[不及]
cin	[名]
cincilambi	[及]
cindaha	[名]
cindahan	[名]
cing	[名][状]
cing keo angga	[名]
cing kko	[名]
cinggambi	[及]
cinggilakv	[名]
cinggin	[名]
cinggir	[状]
cinggiri	[形][名]
cinggiya	[形]
cinggiyakan	[形]
cinggiyan	[形]
cingkaxambi	[及]
cingkai	[副]
cingkambi	[及][不及]
cingnembi	[不及]
cingnur	[名]
cinjiri	[名]
cinuhvlambi	[及]
cinuhvn	[名]
cinurgan	[名]
cio siyang	[形]
cir	[状]
cira	[形][名]
ciralambi	[不及]
cirangga	[形]
circan	[名]
cirgabukv	[形]
cirgashvn	[形]
cirgeku	[名]
cirgembi	[及]
cirhvmbi	[及]
cirhashvn	[形]
cirku	[名]
ciruku	[名]
cirumbi	[及]
cise	[名]
cistan	[名]
cisu	[名]
cisudembi	[不及]
cisui	[形]
cisulembi	[及]
ciyalimbi	[及]
ciyalindumbi	[不及]
ciyan hv	[名]
ciyan zung	[名]
ciyanxi	[名]
ciyang wei	[名]
ciyanliyang	[名]
ciyanzung	[名]
co	[名]
cob	[状]
cobaxambi	[不及]
cobalabumbi	[及]
cobalambi	[及]
coban	[名]
cobangga	[形]
cobdaha	[形]
cobolan	[名]
cobto	[名][副]
cobtojombi	[不及]
cocarambi	[不及]
cocari	[名]
cocirambi	[不及]
coco	[名]
cocori	[名]
codoli	[形]
cohombi	[及]
cohome	[形][副]
cohonggo	[形]
cohoro	[形]
cohoto	[名]
cohotoi	[形][副]
cok cak	[状]
cokvlu	[名]
cokcihiyan	[名]
cokcohon	[形]
coki	[名]
cokimbi	[及]
coko	[名]
cokonggo	[形]
cokto	[形]
coktolombi	[及]
colabumbi	[及]
colambi	[及]
colcombi	[不及]
colgambi	[不及]
colgogan	[形]
colgon	[名]
colgoroko	[形]
colgorombi	[不及]
colgoropi	[形]
colho	[形]
colhon	[名]
colhoroko	[形]
colhorokongge	[形]
colhorombi	[不及]
colhoron	[名]
colikv	[名]
colimbi	[及]
colingga	[形]
colkon	[名]
colo	[名]
coman	[名]
comari	[形]
comboli	[名]
comgombi	[及]
comko	[形]
comlimbi	[及]
comnombi	[及]
como	[名]
concarambi	[及]
concori	[名]
condoho	[名]
conggai	[名]
conggixakv	[名]
conggixambi	[及]
conggimbi	[及]
conggiri	[名]
conggoxombi	[及]
congkixakv	[名]
congkixambi	[不及]
congkibumbi	[及]
congkimbi	[及]
congkiri	[形]
contoho	[名]
contohojombi	[不及]
contombi	[及]
coo	[名]
coobalambi	[及]
coocarambi	[及]
coociyanli	[名]
coogan	[名]
coogombi	[及]
cooha	[名]
coohalambi	[及]
coohan	[名]
coohiyan	[名]
coolambi	[及]
coolgombi	[及]
coolgon	[名]
coolgorombi	[不及]
coolon	[形]
cooman	[名]
cor	[状]
corbokv	[名]
corbombi	[及]
corci	[名]
cordombi	[及]
corho	[名]
corhon	[名]
cori	[名]
coro	[名]
corodai	[名]
coron	[名]
cos	[状]
cosho	[名]
cotho	[名]
cotoli	[形]
cu	[名][状]
cu niru	[名]
cuba	[名]
cubdaha	[形]
cubumbi	[不及]
cucu caca	[状]
cudu	[名]
cuiken	[名]
cuikengge	[形]
cuk	[状]
cukvxambi	[不及]
cukvlo	[形]
cukvlu	[名]
cukvmbi	[不及]
cukcambi	[不及]
cukcuhun	[形]
cukcurembi	[不及]
cuku	[形][名]
cukubumbi	[及]
cukulembi	[及]
cukumbi	[不及]
culasun	[名]
culgambi	[不及]
culgan	[名]
culin	[形]
culuk	[状]
cumcumbi	[不及]
cumcurambi	[不及]
cun	[名]
cun cio	[名]
cunceo	[名]
cung	[状]
cunggvxabumbi	[及]
cunggvxambi	[不及]
cunggai	[名]
cunggur	[形]
cungguru	[名]
cunu	[名]
cur	[状]
curbi	[名]
curcung	[名]
curgimbi	[不及]
curgin	[名]
curgindumbi	[不及]
curhv	[名]
curhvn	[名]
curhimbi	[不及]
curun	[名]
cuse	[名]
cuseingge	[形]
cusengge	[形]
cuseri	[形]
cusile	[名]
cuwan	[名]
cuwangnambi	[及]
cy	[及][名]
cylembi	[及]
cyming	[名]
cyse	[名]
da	[名]
daxurambi	[及]
daxuran	[名]
dabaxakv	[形]
dabaxambi	[不及]
dabagan	[名]
dabakv	[名]
dabala	[后][小]
dabali	[形][名][副]
dabalikan	[形]
dabambi	[及]
daban	[名]
dabanambi	[不及]
dabargan	[名]
dabarhan	[名]
dabci	[形]
dabcikv	[名]
dabcilakv	[名]
dabcilambi	[及]
dabdali	[副]
dabdambi	[及]
dabdurxambi	[不及]
dabduri	[形]
dabdurixambi	[不及]
dabgibumbi	[及]
dabgimbi	[及]
dabgiyambi	[及]
dabixambi	[不及]
dabkvri	[形]
dabkvrilambi	[及]
dabkambi	[不及]
dabkimbi	[及]
dabsi	[名]
dabsitambi	[不及]
dabsulabumbi	[及]
dabsulambi	[及]
dabsun	[名]
dabta	[名]
dabtambi	[及]
dabukv	[名]
dabumbi	[及]
daci	[副]
dacilambi	[不及]
dacukan	[形]
dacun	[形]
dacungga	[形]
dadage	[叹]
dadari	[名]
dade	[连][副]
daden	[形]
dadu	[名]
dadun	[形]
dafaha	[名]
dafun	[名]
dagan	[名]
dagilambi	[及]
dahv	[名]
dahvbumbi	[及]
dahvhan	[名]
dahvlambi	[及]
dahvmbi	[不及]
dahvn dahvn i	[副]
dahvngga	[形]
dahvr	[名]
dahabumbi	[及]
dahacambi	[不及]
dahaduhai	[副]
dahalambi	[及]
dahalan	[名]
dahali	[名]
dahalji	[名]
dahaltu	[名]
dahame	[后][连]
dahan	[名]
dahanduhai	[副]
dahandumbi	[不及]
dahanjimbi	[不及]
dahanumbi	[不及]
dahashvn	[形][后]
dahasi	[名]
dahasu	[形]
dahasun	[名]
dahata	[名]
dahimbi	[不及]
dahin	[副]
dai xeng	[名]
dai mai	[名]
dai tung	[名]
daixambi	[及]
daibihan	[名]
daicilambi	[不及]
daicing	[名]
daidan	[名]
daifaha	[名]
daifan	[名]
daifu	[名]
daifurabumbi	[及]
daifurambi	[及]
daihan	[名]
dailambi	[及]
dailan	[名]
dailanabumbi	[及]
dailanambi	[及]
dailanjimbi	[及]
dain	[名]
daipun	[名]
daiselabumbi	[及]
daiselambi	[及]
dakvla	[名]
dakda dakda	[副]
dakdahvn	[形]
dakdarxambi	[及]
dakdari	[副]
daksa	[名]
dalaha	[名]
dalambi	[及]
dalan	[名]
dalangga	[名]
dalba	[方]
dalbarame	[副]
dalbashvn	[形]
dalda	[名]
daldahan	[名]
daldakv	[及]
daldambi	[及]
daldangga	[名]
dalgan	[名]
dalganambi	[不及]
dalgiyambi	[及]
dalgiyan	[形]
dalhvdambi	[不及]
dalhvkan	[形]
dalhvn	[形]
dalhvwan	[名]
dalhi	[形]
dalhidambi	[及]
dalhitambi	[及]
dalibun	[名]
dalikv	[名]
dalimbi	[及]
dalin	[名]
dalingho	[名]
dalirame	[后]
dalitambi	[及]
dalitungga	[形]
daliyan	[名]
daljakv	[形]
daljangga	[形]
dalji	[名]
daljingga	[形]
dalukan	[形]
dalumbi	[不及]
dambagu	[名]
dambumbi	[及]
damdan	[数]
damin	[名]
damjalabumbi	[及]
damjalambi	[及]
damjan	[名]
damnambi	[及]
damtulabumbi	[及]
damtulambi	[及]
damtun	[名]
damu	[连][副]
dan bi	[名]
dan	[名]
danahvn	[名]
danambi	[不及]
dancalabumbi	[及]
dancalambi	[不及]
dancan	[名]
dancarambi	[不及]
dandara	[名]
dandumbi	[不及]
dang	[状]
dangxan	[名]
dangdaka	[形]
dangdakan	[形]
dangdali	[名]
dangdalilambi	[不及]
dangdambi	[不及]
dangga	[名]
danggi	[小]
danggiri	[名]
dangkan	[名]
dangnahan	[名]
dangnambi	[及]
dangniyabumbi	[及]
dangniyambi	[及]
dangpuli	[名]
dangsaha	[名]
dangse	[名]
dangsimbi	[及]
daniyalambi	[不及]
daniyan	[名]
daniyartu	[名]
danjimbi	[不及]
danosgga	[名]
danumbi	[及]
dar	[状]
dara	[名]
darabumbi	[不及]
daradu	[名]
darakai	[副]
darama	[名]
darambumbi	[及]
darandumbi	[及]
darang	[状]
daranumbi	[及]
darbahvn	[副]
dardan	[名][状]
dardu	[名]
dargvwan	[名]
dargalambi	[不及]
dargimbi	[不及]
dargiya	[名]
dargiyambi	[及]
dargiyan	[名]
darhvwa	[名]
darhvwalambi	[及]
darhvwan	[名]
darha	[名]
darho	[名]
darhoci	[形]
dari	[后]
darimbi	[不及]
darin	[名]
daringga	[形]
darka	[名]
darma	[名]
dartai	[副]
darubumbi	[及][不及]
darudai	[名]
daruga	[名]
daruhai	[形][副]
darumbi	[及]
darun	[名]
dasambi	[及]
dasame	[副]
dasan	[名]
dasangga	[名]
dasargan	[名]
dasartungga	[名]
dasatambi	[及]
dashvwan	[名]
dashvwatu	[名]
dasihikv	[名]
dasihimbi	[及]
dasihiyakv	[名]
dasihiyambi	[及]
dasikv	[名]
dasimbi	[及]
dasin	[名]
dasitambi	[不及]
dasu	[名]
dasukv	[名]
dayabumbi	[及]
dayambi	[不及]
dayanambi	[不及]
dayancambi	[不及]
dayandumbi	[不及]
dayanjimbi	[不及]
dayanumbi	[不及]
de	[名]
debxehun	[形]
debxeku	[名]
debxembi	[不及]
debdederembi	[及]
debderxembi	[及]
debderembi	[及]
debe daba	[副]
debembi	[不及]
deben	[名]
debendembi	[不及]
deberen	[名]
debeye	[名]
debeyen	[及]
debkebumbi	[及]
debkejembi	[不及]
debkelebumbi	[及]
debkelembi	[及]
debkembi	[及]
debse	[名]
debsehun	[形]
debsibuku	[名]
debsidembi	[不及]
debsiku	[名]
debsitembi	[不及]
debtelembi	[及]
debtelin	[名]
debumbi	[及]
dede dada	[形]
dedengge	[形]
dedenggi	[形]
dedubumbi	[及]
deducembi	[不及]
dedun	[名]
dedungge	[形]
defe	[名]
defelinggu	[名]
defengge	[形]
defere	[名]
defu	[名]
degetu	[名]
dehe	[名]
dehebumbi	[及]
dehele	[名]
dehelembi	[及]
deheli	[形]
dehema	[名]
dehembi	[及]
deheme	[名]
dehengge	[形]
dehi	[数]
dehici	[数]
dehite	[数]
dehurembi	[及]
deide	[名]
deijibumbi	[及]
deijiku	[名]
deijimbi	[及]
deijin	[名]
deisun	[名]
deji	[名]
dek dak	[状]
dekdebumbi	[及]
dekdehun	[形]
dekdeku	[名]
dekdeljembi	[不及]
dekdembi	[不及]
dekden	[名]
dekdengge	[形]
dekdenggi	[名]
dekdeni	[形]
dekderxembi	[不及]
dekderhvn	[名]
deken	[形][名]
dekjibumbi	[不及]
dekjiltu	[名]
dekjimbi	[不及]
dekjin	[名]
dekjingge	[形]
delbin	[名]
dele	[方]
delebumbi	[及]
delejen	[形]
deleken	[方]
delen	[名]
delengge	[形]
delerembi	[不及]
deleri	[方][副]
delesi	[名]
delferi	[形]
delfiyen	[形]
delhe	[名]
delhembi	[不及]
delhen	[名]
delhendumbi	[及]
delhentumbi	[及]
delhetu	[名]
deli	[名]
delixembi	[不及]
delihun	[名]
delulembi	[及]
delun	[名]
dembei	[副]
dembi	[不及]
demci	[名]
demesi	[名]
demesilembi	[不及]
demniyecembi	[不及]
demniyelembi	[不及]
demniyembi	[及]
demtu	[名]
demun	[名]
demungge	[形]
den	[形]
dendecembi	[及]
dendembi	[及]
dendenumbi	[及]
deng	[状]
dengge	[形]
denggembi	[及]
dengjan	[名]
dengji	[名]
denglu	[名]
dengnebumbi	[及]
dengnehen	[名]
dengneku	[名]
dengnembi	[及]
dengniyembi	[及]
dengse	[名]
dengselembi	[及]
dengsibumbi	[不及]
dengsimbi	[不及]
dengsitembi	[及]
deo	[名]
deocilembi	[不及]
deocin	[名]
deocingge	[形]
deodenjembi	[及]
deone	[名]
der	[状]
derakv	[形]
derakvlambi	[及]
derbebumbi	[及]
derbehin	[形]
derbehun	[形]
derbembi	[不及]
dercilembi	[及]
derden	[状]
derdu	[名]
dere	[名][小]
derencumbi	[不及]
dereng darang	[形]
derengge	[形]
derenggexembi	[及]
derengtu	[名]
deresu	[名]
deretu	[名]
derge	[形]
dergi	[方]
dergiken	[形]
dergingge	[方]
derhi	[名]
derhuwe	[名]
deribumbi	[不及]
deribun	[名]
derimbi	[不及]
derishun	[形]
derkixembi	[不及]
derkimbi	[不及]
dersen	[名]
dertu	[名]
deserembi	[不及]
deserengge	[形]
deserepi	[形]
desihi	[名]
desihimbi	[及]
desiku	[名]
desunggilembi	[及]
desunggiyembi	[不及]
dethe	[名]
dethengge	[形]
detu	[名]
deyebuku	[名]
deyebumbi	[及]
deyembi	[不及]
deyen	[名]
deyenggu	[名]
deyenggulembi	[不及]
di	[名]
dilbihe	[名]
ding	[名]
dingse	[名]
dise	[名]
diselambi	[及]
diyan	[名]
diyanlambi	[及]
diyansi	[名]
diyanzy	[名]
do	[名]
dobi	[名]
dobiha	[名]
dobihi	[名]
dobiri	[名]
dobke	[名]
dobombi	[及]
dobon	[名]
dobonio	[名]
dobonombi	[及]
dobori	[名]
dobtokv	[名]
dobtolobumbi	[及]
dobtolokv	[名]
dobtolombi	[及]
dobtolon	[名]
dobton	[名]
dobukv	[名]
dobumbi	[及]
dodangga	[名]
dodo	[名]
dodobumbi	[及]
dodombi	[不及]
dodori	[名]
dogo	[形]
dogon	[名]
doha	[名]
doho	[名]
dohoxombi	[不及]
dohodombi	[不及]
doholombi	[及]
doholon	[形]
doidon	[形]
doigomxombi	[及]
doigon	[名]
doingge	[形]
doiton	[形]
dojihiyan	[名]
dok	[状]
dokdo dakda	[状]
dokdohon	[形]
dokdohori	[形]
dokdolambi	[不及]
dokdorxombi	[不及]
dokdorgan	[名]
dokdori	[形]
dokdorilambi	[不及]
dokdorjambi	[不及]
dokdoslambi	[不及]
dokita	[名]
dokjihiyan	[形]
doko	[名]
dokolombi	[不及]
dokomimbi	[不及]
doksidambi	[不及]
doksin	[形]
doksintu	[名]
doksirambi	[不及]
doksoho	[形]
doksohon	[形]
dolbi	[形]
doli	[形][名]
dolmobumbi	[及]
dolmombi	[不及]
dolo	[方]
dolori	[方]
dombi	[不及]
domnobumbi	[及]
domnombi	[不及]
domnon	[名]
domo	[名]
don	[名]
donambi	[不及]
dondoba	[名]
dondon	[名]
dongmo	[名]
dongniyorombi	[不及]
donjimbi	[及]
donjin	[名]
donjinambi	[及]
donjindumbi	[及]
donjinjimbi	[及]
donjinumbi	[及]
doobonggo	[形]
doobumbi	[及]
doobungga	[形]
doocang	[名]
doogan	[名]
doohan	[名]
doohanjimbi	[不及]
doolambi	[及]
dooli	[名]
doombi	[及]
doorambi	[及]
dooran	[名]
doorin	[名]
doose	[名]
dooseda	[名]
doosi	[名]
doosidambi	[及]
dorakv	[形]
dorakvlambi	[不及]
doran	[名]
dordon dardan	[副]
dorgi	[方]
dorgolombi	[不及]
dorgon	[名]
dorgori	[名]
dorimbi	[不及]
doro	[名]
dorohon	[形]
doroi	[名]
dorolombi	[不及]
dorolon	[名]
dorolonjimbi	[不及]
dorolonombi	[不及]
doron	[名]
doronggo	[形]
dosholobumbi	[及]
dosholombi	[及]
doshon	[名]
dosi	[方]
dosikan	[方]
dosikasi	[名]
dosila	[名]
dosimbumbi	[及]
dosin	[名]
dosinambi	[不及]
dosinan	[名]
dosinjimbi	[不及]
dosobumbi	[及]
dosombi	[及]
dosombumbi	[及]
dotori	[名]
doyoljombi	[不及]
doyonggo	[名]
du	[名]
du bu	[名]
du yu	[名]
dube	[名]
dubeheri	[名][副]
dubeingge	[形]
dubembi	[不及]
duben	[名]
dubengge	[形]
dubentele	[形]
dubesilembi	[不及]
dubi	[名]
dubimbi	[不及]
dubise	[名]
dudu	[名][状]
dudungge	[形]
dufe	[名]
dufedembi	[不及]
dugvi	[形]
duha	[名]
duhan	[形]
duhembi	[不及]
duhembumbi	[及]
duibulebumbi	[及]
duibuleci	[连]
duibulembi	[不及]
duibulen	[名]
duici	[数]
duilebumbi	[及]
duilembi	[及]
duilen	[名]
duin	[数]
duina	[名]
duingge	[形]
duinggeri	[数]
duite	[数]
duka	[名]
dukduhun	[形]
dukdurembi	[不及]
dukdurhun	[名]
dukjimbi	[不及]
duksembi	[不及]
duksi	[名]
dulan	[名]
dulba	[形]
dulbadambi	[不及]
dulbakan	[形]
dulduri	[名]
dule	[副]
dulefun	[名]
dulemxeku	[形]
dulemxembi	[及]
dulembi	[不及]
dulembumbi	[及]
dulendembi	[不及]
dulga	[形]
dulgakan	[形]
dulimba	[方]
dulimbaingge	[形]
dulimbangge	[名]
dulimbi	[不及]
dulin	[名]
dumin	[形]
duna	[名]
dunda	[名]
dundambi	[及]
dundan	[名]
dunen	[名]
dung	[名]
dungxun	[名][数]
dungga	[名]
dunggami	[名]
dunggu	[名]
dungki	[形]
dur	[状]
durahvn	[形]
duranggi	[形]
duranggilambi	[不及]
durbe	[名]
durbejen	[形]
durbejengge	[形]
durbejitu	[名]
durbembi	[不及]
durdun	[名]
durdung	[名]
durgecembi	[不及]
durgembi	[不及]
durgimbi	[不及]
durgiya	[名]
durha	[名]
duri	[名]
durilembi	[及]
durimbi	[及]
durinumbi	[及]
durma	[名]
dursuki	[形]
dursukilembi	[及]
dursulembi	[及]
dursulen	[名]
dursun	[名]
durugan	[名]
durujun	[名]
durumbi	[不及]
durun	[名]
durungga	[形]
durusga	[名]
dushubumbi	[及]
dushumbi	[及]
dushun	[形]
dushutembi	[不及]
dusihi	[名]
dusihilebumbi	[及]
dusihilembi	[及]
dusihiyen	[形]
dusy	[名]
dutan	[名]
dute	[名]
dutelembi	[不及]
duthe	[名]
duthengge	[形]
dutu	[名]
duturembi	[不及]
duwali	[名]
duwalibun	[名]
duwalingga	[形]
duwara	[名]
duyembi	[不及]
duyembumbi	[及]
duyen	[名][数]
duyun	[名]
dzai siyang	[名]
dzaihiyang	[名]
dzaisang	[名]
dzaisiyang	[名]
dzamba	[名]
dzambu tib	[名]
dzandzy	[名]
dzang	[名]
dzanse	[名]
dzanselabumbi	[及]
dzanselambi	[及]
dzanselebumbi	[及]
dzanselembi	[及]
dzao ba dalan	[名]
dze ging moo	[名]
dze ing xi	[名]
dze mu poo	[名]
dze tan moo	[名]
dze wei ilha	[名]
dzendze	[名]
dzense	[名]
dzo	[方]
dzoguwan	[名]
dzun hvwa	[名]
dzung bing	[名]
dzungdu	[名]
dzusen	[名]
dzyda	[名]
e	[叹][名][小]
exe	[名]
exebumbi	[及]
exemeliyan	[形]
exen	[名]
exengge	[形]
exenju	[形]
exerge	[形]
ebxembi	[不及]
ebxu	[名]
ebci	[名]
ebcilembi	[不及]
ebdereku	[形]
ebderembi	[及]
ebderen	[名]
ebebe	[叹]
ebeci	[名]
ebegei	[叹]
ebele	[方]
ebembi	[不及]
ebeniyembi	[及]
eberegi	[名]
eberembi	[不及]
eberembumbi	[及]
ebergi	[方]
ebergingge	[形]
eberhuken	[形]
eberhun	[形]
eberi	[形]
eberiken	[形]
eberingge	[名]
ebetuhun	[形]
ebi habi	[形]
ebixembi	[不及]
ebixenembi	[不及]
ebixenumbi	[不及]
ebibumbi	[及]
ebilun	[形]
ebimbi	[不及]
ebken tebken i	[副]
ebsi	[后][副]
ebsixembi	[不及]
ebsihe	[后]
ebsihei	[后][副]
ebsiken	[方]
ebte	[名]
ebubumbi	[及]
ebubun	[名]
ebuhu	[形]
ebumbi	[不及]
ebundumbi	[不及]
ebunembi	[不及]
ebunjibumbi	[及]
ebunjimbi	[不及]
ebunumbi	[不及]
eci	[小]
ecike	[名]
ecimari	[名]
ede	[连]
edede	[状]
ededei	[状]
edekirakv	[形]
edelehengge	[形]
edelembi	[及]
edembi	[不及]
eden	[形]
edena	[副]
edeng	[名]
ederi tederi	[副]
edulembi	[不及]
edumbi	[不及]
edun	[名]
edungge	[形]
edunggiyembi	[及]
eduntu	[名]
efebumbi	[不及]
efehen	[名]
efehun	[名]
efen	[名]
efibumbi	[及]
eficembi	[不及]
efiku	[名]
efimbi	[不及]
efin	[名]
efisi	[名]
efiyen	[名]
efu	[名]
efujembi	[不及]
efujen	[名]
efujendembi	[不及]
efujentu	[名]
efulebumbi	[及]
efulembi	[及]
efulen	[名]
efun	[名]
egipet	[名]
eguletu	[名]
ehe	[形]
ehecumbi	[及]
ehecun	[名]
ehelinggu	[形]
eheliyangge	[形]
eheliyanggu	[形]
eheliyenggu	[形]
ehembi	[不及]
ehengge	[名]
eherembi	[不及]
eherendumbi	[不及]
ehetu	[名]
ehurhen	[名]
ei	[叹][状]
eibi haibi	[形]
eici	[连]
eicibe	[副]
eifu	[名]
eifun	[名]
eifunembi	[不及]
eigen	[名]
eihen	[名]
eiheri	[名]
eihume	[名]
eihumengge	[形]
eihun	[名]
eihuri	[名]
eihutu	[名]
eikte	[名]
eimebumbi	[不及]
eimeburu	[名]
eimecuke	[形]
eimecun	[名]
eimede	[名]
eimedembi	[及]
eimembi	[及]
eimemburu	[形]
eimercuke	[形]
eimerecuke	[形]
eimpe	[名]
eite	[名]
eiten	[名]
eiterxembi	[及]
eitereci	[副]
eiterecibe	[连][副]
eitereku	[名]
eiterembi	[及]
eitereme	[副]
eje	[名]
ejebukv	[名]
ejebumbi	[及]
ejebun	[名]
ejehe	[名]
ejehen	[名]
ejeke	[名]
ejeku	[名]
ejelembi	[及]
ejelendumbi	[及]
ejelenumbi	[及]
ejelesi	[名]
ejeltu	[名]
ejembi	[及]
ejen	[名]
ejesu	[名]
ejetun	[名]
ejetungge	[形]
ejihe	[名]
ek	[状]
ekxembi	[不及]
ekxendumbi	[不及]
ekxenumbi	[不及]
ekxun	[名]
ekcin	[形][名]
eke	[叹][副]
ekehe	[叹]
ekembi	[不及]
ekidun	[名]
ekimbi	[不及]
ekisaka	[副]
ekiyehun	[形]
ekiyembi	[不及]
ekiyen	[名]
ekiyendembi	[不及]
ekiyeniyembi	[不及]
ekiyeniyen	[名]
ektembi	[不及]
ekterxembi	[不及]
el ya	[名]
elbefembi	[不及]
elbeku	[名]
elbembi	[及]
elben	[名]
elbenfembi	[不及]
elbengge	[形]
elbesu	[名]
elbetu	[名]
elbixebumbi	[及]
elbixembi	[不及]
elbixenembi	[不及]
elbibumbi	[及]
elbihe	[名]
elbimbi	[及]
elbindumbi	[不及]
elbinembi	[不及]
elbinumbi	[不及]
elbitun	[名]
elcin	[名]
elcinjimbi	[不及]
eldexembi	[不及]
eldedei	[名]
eldehen	[名]
eldei	[名]
elden	[名]
eldenembi	[不及]
eldengge	[形]
eldenjimbi	[不及]
eldentu	[名]
eldepi	[形]
elderhen	[名]
elderi	[形]
ele	[形]
elebumbi	[及]
elecun	[名]
elehudembi	[不及]
elehun	[形]
elei	[副]
elekei	[副]
elekesaka	[形]
elemangga	[副]
elembi	[不及]
elemimbi	[及]
elen	[名]
elengge	[形]
elenggi	[形]
elengtu	[名]
eletele	[副]
eletembi	[不及]
elgembi	[及]
elgin	[形]
elgiyeken	[形]
elgiyen	[形]
elgiyengge	[形]
elhe	[名]
elhexebumbi	[及]
elhexembi	[不及]
elhebumbi	[及]
elhei	[副]
elhekv	[形]
elheken	[形]
elhembi	[不及]
elhengge	[形]
elherhen	[名]
eli	[叹][名]
elin	[名]
elintu	[名]
elintumbi	[及]
elioi	[名]
elje	[名]
eljembi	[不及]
eljendumbi	[不及]
eljenjimbi	[不及]
eljenumbi	[不及]
elkei	[副]
elkimbi	[及]
elkindumbi	[及]
elkinumbi	[及]
elmin	[名]
elmiyen	[名]
elu	[名]
eluri	[形]
embici	[连]
emci	[名]
emde	[副]
emderi	[副]
emdubei	[副]
eme	[名]
emeke	[名]
emekei	[叹]
emembihede	[副]
ememu	[代]
ememungge	[名][连]
emgeri	[数][副]
emgi	[后][副]
emgilembi	[不及]
emhe	[名]
emhe soro	[名]
emhukesaka	[形]
emhulembi	[及]
emhun	[名][副]
emile	[形]
emilembi	[及]
emilen	[形]
emke	[数]
emkeci akv	[副]
emken	[数]
empi	[名]
empirembi	[及]
emte	[数]
emteli	[形]
emtenggeri	[副]
emtungge	[形]
emu	[数]
emuci	[数]
emude	[副]
emuge	[数]
emursu	[形]
en	[叹]
en jen	[形]
encebumbi	[及]
encehexembi	[不及]
encehedembi	[不及]
encehen	[名]
encehengge	[名]
encembi	[及]
encu	[形]
encuhen	[形]
enculebumbi	[及]
enculembi	[及]
encutu	[名]
endebuku	[名]
endebumbi	[不及]
endembi	[及]
enderi sekderi	[形]
endeslambi	[不及]
enduhen	[名]
enduri	[名]
endurin	[名]
enduringge	[形]
enen	[名]
enenggi	[叹][名]
eneshuken	[形]
eneshun	[形]
enetkek	[名]
eng	[状]
engge	[名]
enggeci	[副]
enggelcembi	[不及]
enggele senggele	[形]
enggelebumbi	[及]
enggelecembi	[不及]
enggeleku	[名]
enggelembi	[不及]
enggelen	[名]
enggelenembi	[不及]
enggelenjimbi	[不及]
enggeleshun	[形]
enggemu	[名]
enggete	[形]
enggetu	[名]
enggici	[副]
enggule	[名]
engki congki	[副]
enihen	[名]
enihun	[形]
enirhen	[名]
eniye	[名]
eniyehen	[名]
eniyehun	[名]
eniyen	[名]
eniyeniye	[名]
enji	[形]
enteheme	[形][副]
enteke	[代]
entekengge	[名]
eo	[名]
eo hi	[名]
erxebumbi	[及]
erxeku	[名]
erxembi	[及][不及]
erde	[名]
erdeken	[形]
erdelembi	[不及]
erdemu	[名]
erdemungge	[形]
ere	[代]
erebumbi	[及]
ereci	[连]
erecuke	[形]
erecun	[名]
erehunjebumbi	[及]
erehunjembi	[及]
ereingge	[形]
erembi	[及]
eremu	[名]
erendumbi	[及]
ereni	[副]
eretele	[副]
ergexembi	[不及]
ergebumbi	[及]
ergece	[名]
ergecun	[名]
ergelembi	[及]
ergelen	[名]
ergeletei	[副]
ergembi	[不及]
ergembumbi	[及]
ergen	[名]
ergendembi	[不及]
ergendumbi	[不及]
ergengge	[名]
ergenumbi	[不及]
ergi	[方]
ergilembi	[及]
ergingge	[名]
ergule	[名]
ergume	[名]
erguwe	[名]
erguwejitu	[名]
erguwembi	[不及]
erguwen	[名]
erhe	[名]
erhelembi	[及]
erhembi	[不及]
erhunjembi	[及]
erhuwe	[名]
erhuweku	[名]
eri	[小]
eribumbi	[及]
erihe	[名]
eriku	[名]
erilembi	[不及]
erimbi	[及]
erimbu	[名]
erin	[名]
eringge	[形]
eritun	[名]
erke	[形]
erken terken	[形]
erki	[形]
erkilembi	[不及]
erku	[名]
erpe	[名]
erpenembi	[不及]
erse	[代]
erselen	[名]
ersulen	[名]
ersun	[形]
ertele	[副]
ertumbi	[不及]
ertun	[名]
eru	[形]
eruken	[形]
erulebumbi	[及]
erulembi	[及]
erumbi	[及]
erumci	[名]
erun	[名]
eruwedebumbi	[及]
eruwedembi	[名]
eruwen	[名]
ese	[代]
eseingge	[名]
eshen	[名]
eshuken	[形]
eshun	[形]
eshungge	[名]
eshurebumbi	[及]
eshurembi	[不及]
eshurumbi	[不及]
esi	[副]
esihvn	[名]
esihe	[名]
esihengge	[形]
esimbi	[不及]
esrun	[名]
esukiyembi	[及]
esunggiyembi	[及]
etehen	[名]
etembi	[及]
eten	[名]
etenggi	[形]
etenggilebumbi	[及]
etenggilembi	[及]
eteri	[形]
etubumbi	[及]
etuhuxebumbi	[及]
etuhuxembi	[不及]
etuhuken	[形]
etuhun	[形]
etuku	[名]
etukulembi	[不及]
etumbi	[及]
eye	[名]
eyebuku	[名]
eyembi	[不及]
eyemeliyan	[副]
eyen	[名]
eyenembi	[不及]
eyer	[状]
eyerxecuke	[形]
eyerxembi	[及]
eyeri	[状]
eyerjembi	[不及]
eyun	[名]
eyungge	[形]
fa	[名]
fa ulhvma	[名]
faxxabumbi	[及]
faxxambi	[不及]
faxxan	[名]
faxxandumbi	[不及]
faxxangga	[形]
faxxanumbi	[不及]
faxu	[名]
fabumbi	[及]
facabumbi	[及]
facambi	[及]
facihin	[名]
facihiyaxabumbi	[及]
facihiyaxambi	[不及]
facihiyaxandumbi	[不及]
facihiyaxanumbi	[不及]
facihiyambi	[不及]
facimbi	[不及]
facuhvlambi	[不及]
facuhvn	[名]
facuhvngge	[形]
facuhvrabumbi	[及]
facuhvrambi	[不及]
fadabumbi	[及]
fadagan	[名]
fadambi	[及]
fadarhvn	[名]
fadu	[名]
fadulabumbi	[不及]
fadulambi	[及]
fafaha	[名]
fafuha	[名]
fafulambi	[及]
fafun	[名]
fafungga	[形]
fafurxabumbi	[及]
fafurxambi	[不及]
fafuri	[形]
fafuringga	[形]
fafushvlambi	[不及]
fafushvn	[名]
fahvn	[名]
faha	[名]
fahabumbi	[及]
fahala	[形]
fahambi	[及]
fahanambi	[及]
faharambi	[及]
fahari	[名]
fahartu	[名]
fahi	[名]
faicima	[形]
faidabumbi	[及]
faidambi	[及]
faidan	[名]
faidanambi	[及]
faidandumbi	[不及]
faidangga	[形]
faidanumbi	[不及]
faidasi	[名]
faifan	[名]
faifuhalambi	[及]
faihacambi	[不及]
faijima	[形]
faijime	[形]
faijuma	[形]
faijume	[形]
faisha	[名]
faishalabumbi	[及]
faishalambi	[及]
faishan	[名]
faitaburu	[名]
faitakv	[名]
faitambi	[及]
faitan	[名]
faitanumbi	[及]
faitarabumbi	[及]
faitarambi	[及]
fajambi	[不及]
fajan	[名]
fajiran	[名]
faju	[名]
fajukv	[名]
fak	[状]
fak fak	[副]
fakv	[名]
fakvri	[名]
faka	[名]
fakaxambi	[不及]
fakaca	[名]
fakadambi	[不及]
fakari	[形]
fakcabumbi	[及]
fakcambi	[不及]
fakcan	[名]
fakcashvn	[形]
fakdangga	[形]
fakiri	[形]
fakjilambi	[不及]
fakjin	[名]
faksa	[副]
faksabun	[名]
faksalabumbi	[及]
faksalambi	[及]
faksalan	[名]
faksi	[形]
faksidambi	[不及]
faksikan	[形]
faksingga	[形]
falan	[名]
falanggv	[名]
falangga	[形]
falasu	[名]
falga	[名]
falgangga	[名]
falgari	[名]
falha	[名]
fali	[名]
falimbi	[及]
falin	[名]
falindumbi	[不及]
falingga	[形]
falintambi	[不及]
falintu	[形]
falmahvn	[名]
falu	[名]
famambi	[及]
fambi	[不及]
fambumbi	[及]
famha	[名]
fan	[名]
fan i	[名]
fancabumbi	[及]
fancacuka	[形]
fancacun	[名]
fancakv	[名]
fancambi	[不及]
fancarambi	[及]
fandi	[名]
fandzi	[名]
fang	[状]
fang dze	[名]
fang gin	[名]
fang jang	[名]
fangxakv	[名]
fangxambi	[及]
fangxangga	[形]
fangdze	[名]
fangga	[形]
fangkabumbi	[及]
fangkakv	[名]
fangkala	[形]
fangkalakan	[形]
fangkambi	[不及]
fangnai	[副]
fangnambi	[及]
fangse	[名]
fangsikv	[名]
fanihiyan	[名]
faniyahiyan	[名]
far	[状]
farxambi	[及]
farxatai	[副]
fara	[名]
farabumbi	[及]
faradambi	[不及]
farambi	[不及]
farambumbi	[及]
farang	[状]
farangga	[形]
farfambi	[及]
fargambi	[及]
farganambi	[及]
fargi	[名]
farhvxambi	[不及]
farhvdambi	[不及]
farhvkan	[形]
farhvn	[形]
farha	[形]
faringgiyambi	[及]
farsa	[名]
farsi	[名]
farsilabumbi	[及]
farsilambi	[及]
farsinambi	[不及]
fartahvn	[形]
farudai	[名]
fasak	[状]
fasan	[名]
fasar	[状]
fase	[名]
fasibumbi	[及]
fasilan	[名]
fasilangga	[形]
fasimbi	[不及]
fatak	[状]
fatambi	[及]
fatan	[名]
fatanambi	[及]
fatanjimbi	[及]
fatanumbi	[及]
fatar	[状]
fatarxabumbi	[及]
fatarxambi	[及]
fatarambi	[及]
fatari	[形]
fatha	[名]
fathaxambi	[不及]
fathacambi	[不及]
fayabumbi	[及]
fayabun	[名]
fayambi	[及]
fayangga	[名]
fe	[形]
fexxembi	[及]
febegiyembi	[不及]
febgiyembi	[不及]
febigi	[名]
febihi	[名]
febumbi	[不及]
feciki	[叹][形]
fecitembi	[及]
fecuhun	[形]
fede	[小]
fefe	[名]
feherembi	[不及]
feheren	[名]
fehi	[名]
fehuhen	[名]
fehulembi	[及]
fehumbi	[及]
fehun	[名]
fehunembi	[及]
fehutembi	[及]
fehutenumbi	[及]
fei	[名]
fei dze	[名]
fei dzoo	[名]
fei gin	[名]
fei jui	[名]
feifumbi	[及]
feigin	[名]
feihu	[名]
feingge	[形]
feise	[形]
fejergi	[方]
fejergingge	[方]
fejile	[方]
fejilebumbi	[及]
fejilembi	[及]
fejilen	[名]
fejun	[形]
fekxembi	[及]
fekxulembi	[及]
fekxun	[名]
fekceku	[名]
fekcembi	[不及]
fekcuhuken	[形]
fekcuhun	[形]
fekcuri	[名]
feksibumbi	[及]
feksiku	[名]
feksimbi	[不及]
feksimbumbi	[及]
feksin	[名]
feksindumbi	[不及]
feksinumbi	[不及]
fekucembi	[不及]
fekucenumbi	[不及]
fekumbi	[及]
fekumbumbi	[及]
fekun	[名]
fekunembi	[不及]
fekunjimbi	[不及]
fekuri	[名]
fekuteme	[副]
felebumbi	[及]
felehudembi	[不及]
felehun	[形]
feleku	[名]
felembi	[及]
felhen	[名]
felheri	[形]
feliyebumbi	[及]
feliyembi	[不及]
fembi	[及][不及]
femen	[名]
fempi	[名]
fempilebumbi	[及]
fempilembi	[及]
fen	[名]
fendze	[名]
fenehe	[形][名]
fenehin	[名]
fenfuliyer	[副]
fengxen	[名]
fengxengge	[形]
fengkin	[名]
fengse	[名]
fengseku	[名]
fengsi	[名]
fengtu	[名]
fenihe	[形]
fenihiyen	[名]
feningge	[形]
feniyeku	[形]
feniyelembi	[不及]
feniyembi	[及]
feniyen	[名]
feniyengge	[形]
feo io	[名]
fepi	[名]
fer	[状]
ferahe	[名]
fere	[名]
ferehe	[形]
ferembi	[不及]
feretu	[名]
ferge	[名]
fergecun	[名]
fergelembi	[及]
fergembi	[不及]
fergetun	[名]
ferguwebumbi	[及]
ferguwecuke	[形]
ferguwecun	[名]
ferguwembi	[及]
ferguwen	[名]
ferguwendumbi	[及]
ferguwenumbi	[及]
ferhe	[名]
ferhelembi	[及]
feri	[名]
ferkingge	[形]
ferten	[名]
fesen	[名]
feser	[状]
feshexembi	[及]
fesheku	[名]
fesheleku	[名]
feshelembi	[及]
feshembi	[不及]
feshen	[名]
fesherembi	[及]
feshuxembi	[及]
feshulembi	[及]
fesin	[名]
fesku	[名]
fetecun	[名]
feteku	[名]
fetembi	[及]
feten	[名]
fetenumbi	[及]
fetereku	[形]
feterembi	[及]
feteren	[名]
feteri	[名]
feterilembi	[不及]
fethe	[名]
fethexembi	[不及]
fetheku	[名]
fethekulembi	[及]
feye	[名]
feyelembi	[不及]
feyengge	[形]
feyesi	[名]
fi	[名]
fixur	[状]
ficakv	[名]
ficakvngge	[形]
ficambi	[及]
fican	[名]
ficari	[名]
fidambi	[及]
fidembi	[及]
fidenembi	[及]
fifacambi	[不及]
fifambi	[不及]
fifan	[名]
fifangga	[形]
fifari	[名]
fiha	[形]
fihaxambi	[不及]
fihali	[形]
fihalikan	[形]
fihanambi	[不及]
fihe	[名]
fihebumbi	[及]
fihembi	[不及]
fihen	[名]
fihenembi	[不及]
fihenjimbi	[不及]
fihete	[形]
fijirembi	[不及]
fijirhi	[名]
fijiri	[名]
fik	[状]
fika	[名]
fikaci	[名]
fikanambi	[不及]
fikatala	[副]
fikte	[形]
fiktu	[名]
fila	[名]
filan	[名]
filebumbi	[及]
fileku	[名]
filembi	[不及]
filfin	[形]
fili	[形]
filikan	[形]
filingga	[形]
filtahvn	[形]
fimebumbi	[及]
fimembi	[及]
fimenembi	[及]
fina	[名]
fing	[状]
fingge	[名]
fingkabumbi	[不及]
fintabumbi	[及]
fintacuka	[形]
fintambi	[不及]
fintehe	[名]
fintembi	[不及]
fio	[名][状]
fioha	[名]
fiokon	[名]
fiokorombi	[不及]
fior	[状]
fiose	[名]
fiota	[名]
fiotambi	[不及]
fiotombi	[不及]
fir	[状]
firfin	[名]
firgembi	[及]
firgendembi	[不及]
firumbi	[及]
firundumbi	[及]
fisa	[名]
fiseku	[名]
fisekulembi	[不及]
fisembi	[不及]
fisembumbi	[及]
fisengge	[形]
fisha	[名]
fishaci	[名]
fisihe	[名]
fisihibumbi	[及]
fisihimbi	[及]
fisihiyembi	[及]
fisikan	[形]
fisiku	[名]
fisin	[形]
fisitun	[名]
fita	[副]
fithebumbi	[及]
fithejembi	[不及]
fitheku	[名]
fithembi	[及]
fithen	[名]
fithengge	[形]
fituhan	[名]
fiya	[名]
fiyaxambi	[不及]
fiyabkv	[名]
fiyacumbi	[不及]
fiyada	[名]
fiyagambi	[不及]
fiyagan	[名]
fiyaganambi	[不及]
fiyaganjambi	[及]
fiyahan	[名]
fiyahanambi	[及]
fiyahanjambi	[及]
fiyaju	[名]
fiyajumbi	[不及]
fiyak	[状]
fiyakvbumbi	[及]
fiyakvmbi	[不及]
fiyakvngga	[形]
fiyakiyambi	[及]
fiyakiyan	[名]
fiyaksa	[名]
fiyalanggi	[名]
fiyalar	[状]
fiyalhv	[名]
fiyalhvn	[名]
fiyan	[名]
fiyana	[名]
fiyanarakv	[名]
fiyanarambi	[及]
fiyancihiyaxambi	[不及]
fiyancihiyan	[形]
fiyanggv	[形]
fiyanggvxambi	[不及]
fiyangga	[形]
fiyangtahvn	[形]
fiyangtahvri	[形]
fiyangtanambi	[不及]
fiyanji	[名]
fiyanjilabumbi	[及]
fiyanjilambi	[及]
fiyanjirembi	[及]
fiyantoro	[名]
fiyar	[状]
fiyaren	[名]
fiyaringgiyabumbi	[及]
fiyaringgiyambi	[及]
fiyartun	[名]
fiyartunambi	[不及]
fiyaru	[名]
fiyarunahangge	[名]
fiyarunambi	[不及]
fiyarunarangge	[名]
fiyarunaru	[名]
fiyasambi	[不及]
fiyasha	[名]
fiyatar	[状]
fiyatarakv	[名]
fiye	[名]
fiyefun	[名]
fiyegu	[名]
fiyehu	[名]
fiyelebuku	[名]
fiyelekv	[形]
fiyeleku	[形]
fiyelembi	[及]
fiyelen	[名]
fiyelenggu	[名]
fiyelesu	[名]
fiyelfe	[名]
fiyen	[名]
fiyene	[名]
fiyenggu	[名]
fiyengseri	[名]
fiyentehe	[名]
fiyentehejebumbi	[及]
fiyentehejembi	[不及]
fiyentehengge	[形]
fiyentembi	[及]
fiyenten	[名]
fiyeolehe	[名]
fiyerembi	[不及]
fiyeren	[名]
fiyerenembi	[不及]
fiyereren	[名]
fiyo	[名]
fiyoho	[名]
fiyohombi	[不及]
fiyokocombi	[不及]
fiyokojombi	[不及]
fiyokon	[名]
fiyokorombi	[不及]
fiyolor	[状]
fiyoo	[名]
fiyookorombi	[不及]
fiyoose	[名]
fiyootambi	[不及]
fiyootombi	[不及]
fiyor	[状]
fiyorhon	[名]
fiyotokv	[名]
fiyotombi	[及]
fo	[名]
fo xeo	[名]
fo ding sin to lo ging	[名]
fo sang	[名]
foxor	[状]
fodo	[名]
fodoba	[名]
fodoho	[名]
fodombi	[不及]
fodor	[状]
fodorombi	[及]
fohodombi	[不及]
foholokon	[形]
foholon	[形]
fohotombi	[不及]
foifokv	[名]
foifombi	[及]
foihori	[副]
foihorilambi	[及]
foji	[名]
fokjihiyadambi	[不及]
fokjihiyan	[形]
fokto	[名]
folgo	[名]
folho	[名]
folkolombi	[及]
folobumbi	[及]
folombi	[及]
folon	[名]
folonggo	[形]
fombi	[不及]
fomilambi	[及]
fomilembi	[及]
fomoci	[名]
fomon	[名]
fomorombi	[不及]
fon	[名]
fonde	[后]
fondo	[副]
fondojombi	[不及]
fondolombi	[及]
fongko	[名]
fongsombi	[及]
fongson	[名]
fongsonggi	[名]
fongsorombi	[及]
fonio	[名]
foniyo	[名]
foniyoo	[名]
fonjimbi	[及]
fonjin	[名]
fonjinambi	[及]
fonjindumbi	[及]
fonjinjimbi	[及]
fonjinumbi	[及]
fonjisi	[名]
fontoho	[名]
for	[状]
fordehe	[名]
forfoi	[名]
forgoxambi	[及]
forgoxombi	[及]
forgombi	[及]
forgon	[名]
forgori	[形]
forikv	[名]
forimbi	[及]
foringga	[形]
foringgiyambi	[及]
foritu	[名]
forjin	[名]
forko	[名]
forobumbi	[及]
forobun	[名]
forohvn	[名]
forombi	[及]
foron	[名]
foronombi	[不及]
forontu	[形]
fortohon	[形]
foskiyambi	[不及]
fosoba	[名]
fosok	[状]
fosokiyambi	[不及]
fosolhon	[名]
fosombi	[不及]
fosomibumbi	[及]
fosomikv	[形]
fosomimbi	[及]
foson	[名]
fosonjimbi	[不及]
fosonombi	[不及]
fosor	[状]
fotor	[状]
foyo	[名]
foyodobumbi	[及]
foyodombi	[及]
foyodon	[名]
foyonombi	[不及]
foyori	[名]
foyoro	[名]
fu	[形][名][状]
fu hai	[名]
fu nimaha	[名]
fuxahv	[名]
fuxarcan	[名]
fuxargan	[名]
fuxi	[名]
fubihvn	[形]
fubise	[名]
fubumbi	[及]
fucebumbi	[及]
fucembi	[不及]
fucendumbi	[不及]
fuceng	[名]
fucenumbi	[不及]
fucihi	[名]
fucihingge	[形]
fucihiyaxambi	[及]
fucihiyabumbi	[不及]
fucihiyalambi	[及]
fucihiyambi	[不及]
fucu faca	[副]
fudambi	[及]
fudangga	[形]
fudarambi	[不及]
fudarame	[连]
fudaran	[名]
fudasi	[名]
fudasihvlambi	[不及]
fudasihvn	[形]
fudexebumbi	[及]
fudexembi	[不及]
fudehun	[形]
fudejembi	[不及]
fudelembi	[及]
fudembi	[及]
fudenembi	[及]
fudenjimbi	[及]
fudze	[名]
fufa	[状]
fufudambi	[及]
fufumbi	[及]
fufun	[名]
fufundambi	[及]
fufutambi	[不及]
fugiyan	[名]
fugu	[名]
fuhaxabumbi	[及]
fuhaxambi	[不及]
fuhacan	[名]
fuhali	[副]
fuhexebumbi	[及]
fuhexeku	[形]
fuhexembi	[不及]
fuhen	[名]
fuhesembi	[及]
fuhiyembi	[不及]
fuhu	[名]
fuhun	[名]
fuifukv	[名]
fuifumbi	[及]
fujin	[名]
fujiyang	[名]
fujulambi	[及]
fujurakv	[形]
fujurakvngge	[形]
fujuri	[形]
fujurulabumbi	[及]
fujurulambi	[及]
fujurun	[名]
fujurungga	[形]
fuka	[名]
fukanambi	[不及]
fukcihiyadambi	[不及]
fukcihiyan	[形]
fukcin	[名]
fukdejembi	[不及]
fukderembi	[不及]
fukiyambi	[及]
fukiyembi	[不及]
fukjixambi	[不及]
fukjihiyadambi	[不及]
fukjilambi	[不及]
fukjin	[名]
fukjingga	[形]
fuksuhu	[名]
fuktala	[名]
fulaburu	[形]
fulacan	[名]
fulahvkan	[形]
fulahvn	[形][名]
fulahvri	[形]
fulaka	[形]
fulakan	[形]
fulakcan	[名]
fulan	[形]
fulana	[名]
fularxambi	[不及]
fularambi	[不及]
fulargan	[名]
fulari	[形]
fularilambi	[不及]
fularjambi	[不及]
fulata	[名]
fulca	[名]
fulcengge	[形]
fulcin	[名]
fulcu	[名]
fulcuhvn	[形]
fulcun	[名]
fuldun	[名]
fuldurembi	[不及]
fulehe	[名]
fulehengge	[形]
fulehu	[名]
fulehun	[名]
fulehungga	[形]
fulehungge	[形]
fulehusi	[名]
fulenggi	[名]
fulenggingge	[形]
fulfintu	[形]
fulga	[名]
fulgambi	[及]
fulgidei	[名]
fulgike	[名]
fulgiyaci	[名]
fulgiyakan	[形]
fulgiyan	[名]
fulgiyangga	[形]
fulgiyari	[形]
fulgiyeku	[名]
fulgiyembi	[及]
fulgiyentu	[名]
fulhv	[名]
fulhvca	[名]
fulhvma	[名]
fulhvsun	[名]
fulha	[名]
fulhambi	[不及]
fulheri	[名]
fulhumbi	[不及]
fulhun	[名]
fulhurembi	[不及]
fulhuren	[名]
fulhutu	[名]
fuli	[名]
fulibumbi	[及]
fulimbi	[不及]
fulimbumbi	[不及]
fulin	[名]
fulingga	[形]
fuliyambi	[及]
fuliyambumbi	[及]
fulkvran	[名]
fulkita	[名]
fulmai	[形]
fulmin	[名]
fulmiyembi	[及]
fulmiyen	[名]
fulmun	[形]
fulnaci	[形]
fulnihe	[名]
fulniyeri	[形]
fulsunio	[名]
fulsuri	[形]
fulu	[形][名]
fulukan	[形]
fulun	[名]
fulungga	[名]
fulungge	[形]
fuma	[名]
fumbi	[及]
fumerembi	[不及]
fun	[名]
funcebumbi	[及]
funcehengge	[名]
funcembi	[不及]
funcen	[名]
funcetele	[副]
funde	[名][副]
fundehun	[形]
fundesi	[名]
funembi	[不及]
funfulambi	[及]
fung	[名]
fung sao	[名]
fung siyan diyan	[名]
fung tiyan	[名]
fungxun	[形]
funggaha	[名]
funggala	[名]
funggin	[名]
funghvwang	[名]
fungkv	[名]
fungkeri	[形]
fungku	[名]
funglu	[名]
fungnehen	[名]
fungnembi	[不及]
fungsan	[形]
fungse	[名]
fungto	[名]
fungtoo	[名]
funima	[名]
funiyagan	[名]
funiyagangga	[形]
funiyaha	[名]
funiyahan	[名]
funiyangga	[形]
funiyehe	[名]
funiyehelembi	[不及]
funiyehengge	[形]
funiyertu	[名]
funiyesen	[名]
funiyesun	[名]
funjima	[名]
funtambi	[不及]
funtan	[名]
funtanambi	[不及]
funtombi	[不及]
funtu	[名]
funtuhu	[形][名]
funtuhulembi	[及]
funtuhun	[名]
funtumbi	[不及]
funturxambi	[及]
funturxembi	[及]
funturambi	[及]
fur	[状]
furambi	[不及]
furanambi	[不及]
furcan	[名]
furdan	[名]
furdehe	[名]
furderembi	[不及]
furelambi	[及]
furfu	[名]
furfun farfan	[副]
furgi	[名]
furgimbi	[不及]
furgin	[形][名]
furgisi	[名]
furgisu	[名]
furhvn	[形]
furhun	[形]
furimbi	[不及]
furitan	[名]
furitu	[形]
furna	[名]
fursun	[名]
fursungga	[形]
furu	[名]
furudambi	[不及]
furukv	[名]
furumbi	[及]
furun	[名]
furunambi	[不及]
furungga	[形]
furunumbi	[及]
furusun	[形]
fusa	[名]
fuse	[副]
fusejembi	[不及]
fuselembi	[及]
fuseli	[名]
fusembi	[不及]
fusembumbi	[及]
fusen	[名]
fusengge	[形]
fuserebumbi	[及]
fuserembi	[及]
fuseri	[名]
fushambi	[不及]
fushebumbi	[及]
fusheku	[名]
fushembi	[及]
fushu	[名]
fushubumbi	[及]
fushumbi	[不及]
fusi	[形][名]
fusihvxabumbi	[不及]
fusihvxambi	[及]
fusihvlambi	[及]
fusihvn	[形][方]
fusihen	[名]
fusilaru	[名]
fusimbi	[及]
fusu fasa	[形]
fusuku	[名]
fusumbi	[及]
fusur	[状]
fusuri	[形]
fusurjembi	[不及]
fusutu	[名]
futa	[名]
futahi	[名]
futalabumbi	[及]
futalambi	[及]
fuwen	[名]
fuyakiyambi	[不及]
fuyambi	[不及]
fuyan	[形]
fuyari	[形]
fuyebumbi	[及]
fuyendumbi	[及]
fuyenumbi	[及]
gvbadaxambi	[不及]
gvbadambi	[不及]
gvbcibumbi	[及]
gvbcimbi	[及]
gvbimbi	[及]
gvbiri	[名]
gvca	[名]
gvcihiyamxambi	[不及]
gvcila	[名]
gvdu gada	[副]
gvdumbi	[不及]
gvi gvi	[状]
gvje	[叹]
gvla	[形]
gvlabumbi	[及]
gvlakv	[名]
gvlambi	[不及]
gvldargan	[名]
gvldarkvlambi	[不及]
gvldun	[名]
gvldurambi	[及]
gvlduri	[名]
gvldurimbi	[及]
gvldusi	[名]
gvlga	[名]
gvlganambi	[不及]
gvlgi	[形]
gvlgin	[名]
gvlgirakv	[形]
gvlha	[名]
gvlhi	[名]
gvli gali	[状]
gvlibumbi	[及]
gvlimbi	[不及]
gvlin	[名]
gvlja	[名]
gvljambi	[不及]
gvljarhan	[名]
gvlmahvn	[名]
gvlmahvngga	[形]
gvlu gala	[副]
gvman	[名]
gvmbi	[及][不及]
gvn	[名]
gvna	[名]
gvnaka	[名]
gvnan	[名]
gvng gang	[状]
gvnggala	[名]
gvnggari	[名]
gvngkali	[名]
gvngkambi	[不及]
gvngkan	[名]
gvngkanambi	[不及]
gvnibumbi	[及]
gvnici	[副]
gvnicun	[名]
gvnigan	[名]
gvnigangga	[形]
gvnihakv	[副]
gvnihangga	[形]
gvnijan	[名]
gvnimbi	[及]
gvnin	[名]
gvninambi	[及]
gvningga	[形]
gvninjacuka	[形]
gvninjambi	[不及]
gvr gvr	[状]
gvr gar	[状]
gvrakvxambi	[不及]
gvran	[名]
gvrbambi	[不及]
gvrbi	[名]
gvrbimbi	[不及]
gvrgi	[名]
gvrgilabumbi	[及]
gvrgilambi	[不及]
gvrgin	[名]
gvrgitu	[名]
gvsa	[名]
gvsici	[数]
gvsihiya	[名]
gvsin	[数]
gvsinggeri	[数]
gvsita	[数]
gvsu	[名]
gvsulambi	[及]
gvtubumbi	[及]
gvtucun	[名]
gvwa	[形][代]
gvwaxxabumbi	[及]
gvwaxxambi	[及][不及]
gvwaxxan	[名]
gvwaxabumbi	[不及]
gvwaxambi	[不及]
gvwabsi	[副]
gvwacihiya	[形]
gvwacihiyaxambi	[不及]
gvwacihiyalabumbi	[不及]
gvwacihiyalambi	[不及]
gvwahiyan	[名]
gvwahiyatu	[名]
gvwaicuka	[形]
gvwaidabumbi	[及]
gvwaidambi	[不及]
gvwaidanambi	[不及]
gvwainambi	[不及]
gvwaingge	[代]
gvwaisuntumbi	[不及]
gvwaliyaxakv	[名]
gvwaliyaxambi	[不及]
gvwaliyabumbi	[及]
gvwaliyadambi	[及]
gvwaliyambi	[不及]
gvwaliyanxambi	[不及]
gvwaliyandambi	[及]
gvwambi	[不及]
gvwambumbi	[及]
gvwan dui	[名]
gvwancihiyan	[形]
gvwanumbi	[不及]
gvwar gvwar	[状]
gvwarimbi	[不及]
gvwasihiya	[名]
gvyambi	[不及]
gvyandumbi	[不及]
gaxan	[名]
gabxambi	[及]
gaba	[名]
gabsihiyalabumbi	[及]
gabsihiyalambi	[不及]
gabsihiyan	[形]
gabsiyan	[名]
gabtaxambi	[及]
gabtakv	[形]
gabtambi	[及]
gabtame	[名]
gabtan	[名]
gabtanambi	[不及]
gabtandumbi	[不及]
gabtanjimbi	[不及]
gabtanumbi	[不及]
gabtarambi	[不及]
gabula	[形]
gacilabumbi	[及]
gacilambi	[及]
gacilan	[名]
gacuha	[名]
gadahvn	[形]
gadana	[形]
gadar	[状]
gadarabumbi	[及]
gadarambi	[不及]
gafa	[名]
gahv	[名]
gahvxambi	[不及]
gahvxatambi	[不及]
gahvhan	[名]
gahvmbi	[不及]
gahvngga	[形]
gahvri	[形]
gahvrilambi	[不及]
gaha	[名]
gahacin	[名]
gahangga	[形]
gahari	[名]
gai	[名][状]
gaibuxabumbi	[不及]
gaibuxambi	[不及]
gaidumbi	[及]
gaihahv	[形]
gaihamsitu	[形]
gaihari	[形][副]
gaiharilambi	[不及]
gaihasu	[形]
gaijambi	[及]
gaikabumbi	[及]
gaikambi	[不及]
gaimbi	[及]
gaindumbi	[及]
gainumbi	[及]
gaisilambi	[不及]
gaisilan	[名]
gaisilandumbi	[不及]
gaisilanumbi	[不及]
gaisin	[名]
gaitai	[副]
gajaraci	[名]
gajarci	[名]
gajarcilabumbi	[及]
gajarcilambi	[及]
gajimbi	[及]
gajungga	[形]
gakahvn	[形]
gakarabumbi	[及]
gakarambi	[不及]
gakarashvn	[形]
gakda	[形]
gakdahvn	[形]
gakdahvri	[形]
gakdun	[名]
gaksi	[名]
gala	[名]
galadabumbi	[不及]
galadambi	[不及]
galaktun	[名]
galambi	[不及]
galamu	[名]
galangga	[形]
galatu	[形]
galbi	[形]
galbingga	[形]
galga	[形]
galgan	[形]
galgibumbi	[不及]
galgimbi	[不及]
gali	[形]
galin	[名]
galirambi	[不及]
galju	[形]
galman	[名]
gamambi	[及]
gaman	[名]
gamji	[形]
gamjidambi	[不及]
gamjilambi	[不及]
ganada	[名]
ganambi	[及]
gancuha	[形]
gang	[状]
ganggahvn	[形]
ganggan	[形]
ganggari	[形]
ganggata	[形]
ganggi	[数]
ganio	[名]
ganiongga	[形]
ganji	[副]
ganjuhalambi	[及]
ganjuhan	[名]
gaowa	[名]
gar	[状]
garxa	[名]
garbahvn	[形]
gardaxambi	[不及]
gardambi	[不及]
gardari	[名]
gargalabumbi	[及]
gargalambi	[不及]
gargan	[名]
garganambi	[不及]
gargangga	[形]
gargata	[形]
gargatalambi	[及]
gargimbi	[不及]
gargitai	[副]
gargiyakan	[形]
gargiyan	[形]
garhata	[形]
garhatalambi	[及]
gari mari	[状]
garici	[名]
garimbi	[不及]
garin	[名]
garingga	[名]
garjabumbi	[及]
garjambi	[不及]
garjashvn	[形]
garjihvn	[名]
garlabumbi	[及]
garlambi	[不及]
garlan	[名]
garma	[名]
garmibumbi	[及]
garmimbi	[及]
garsa	[形]
garsakan	[形]
garu	[名]
garu turu	[副]
garudai	[名]
garudangga	[形]
garukiyari	[名]
garun	[名]
garunggv	[名]
gasacun	[名]
gasambi	[不及]
gasan	[名]
gasandumbi	[不及]
gasanumbi	[不及]
gashvbumbi	[及]
gashvmbi	[不及]
gashvn	[名]
gashvngga	[形]
gashvtai	[副]
gasha	[名]
gashan	[名]
gashangga	[形]
gasihiyambi	[及]
gasihiyandumbi	[及]
gasihiyanumbi	[及]
gathvwa	[名]
ge ga	[状]
ge	[名]
gexan	[名]
gexen	[名]
gebge gabga	[副]
gebkeljembi	[不及]
gebsehun	[形]
gebserembi	[不及]
gebu	[名]
gebukv	[形]
gebulembi	[不及]
gebungge	[名]
gecembi	[不及]
gecen	[名]
geceri	[形]
gecetu	[形]
gecuheri	[名]
gecuhun	[名]
gedehun	[形]
gedubumbi	[及]
gedumbi	[及]
gedurebumbi	[及]
gedurembi	[及]
gefehe	[名]
geferi	[形]
gege	[名]
gegeingge	[名]
gegengge	[名]
gehexembi	[及]
gehenakv	[形]
gehu	[形]
gehuken	[形]
gehulembi	[不及]
gehumbi	[不及]
gehun	[形]
gehungge	[形]
gei sere	[状]
geigehun	[形]
geigen	[名]
geigerembi	[不及]
geje gaja	[副]
gejenggi	[形]
geji	[名]
gejihexembi	[及]
gejing	[状]
gejir	[状]
gejun	[名]
gejungge	[形]
gejurebumbi	[及]
gejureku	[名]
gejurembi	[及]
gekdehun	[形]
gelambi	[不及]
gelecuke	[形]
geleku	[名]
gelembi	[不及]
gelendumbi	[不及]
gelenumbi	[不及]
gelerxembi	[不及]
gelerjebumbi	[及]
gelerjembi	[不及]
gelesu	[形]
gelfiyeken	[形]
gelfiyen	[形]
gelhun	[副]
geli	[副]
gelmerjembi	[不及]
gembi	[及]
gemu	[副]
gemulembi	[不及]
gemun	[名]
gemungge	[形]
gen	[名]
gen gan	[形]
gencehexembi	[及]
gencehelebumbi	[及]
gencehelembi	[及]
gencehen	[名]
gencehengge	[形]
gencihelembi	[及]
gencihen	[名]
genebumbi	[及]
genembi	[不及]
genereleme	[副]
gengge gangga	[副]
genggecembi	[不及]
genggedembi	[不及]
genggehun	[形]
genggele	[形]
genggen	[形]
genggerembi	[不及]
genggin	[形]
genggitungga	[形]
genggiyeken	[形]
genggiyelebumbi	[及]
genggiyelembi	[及]
genggiyen	[形]
genggiyenekv	[形]
genggiyengge	[形]
genggiyesu	[名]
genggumbi	[不及]
genumbi	[不及]
geo	[形]
geoxen	[名]
geoxeri	[名]
geodebumbi	[及]
geodehen	[形]
geoden	[名]
geoge	[名]
geogedembi	[不及]
geohe	[名]
geohedembi	[不及]
geolecembi	[及]
geolembi	[及]
ger	[状]
gerben garban	[副]
gerci	[名]
gercilembi	[不及]
gerdung	[名]
gereken	[形]
gerembi	[不及]
gerembumbi	[不及]
geren	[形]
gerenembi	[不及]
gerenggele	[副]
gergen	[名][状]
gergiyen	[名]
gerguwengge	[形]
gerhen	[名]
gerhin	[名]
geri	[形][名]
gerixeku	[名]
gerixembi	[不及]
gerilambi	[不及]
gerilembi	[不及]
gerinjembi	[不及]
gerisiku	[名]
geritu	[名]
gerkuxembi	[不及]
gersi fersi	[名]
gerudei	[名]
gese	[形][后]
gesejembi	[不及]
gesengge	[后]
geser	[形]
gesumbi	[不及]
gesungge	[形]
getebumbi	[及]
getehun	[形]
getehuri	[形]
getembi	[不及]
geterembi	[不及]
geterembumbi	[及]
geterentu	[名]
geterilabumbi	[及]
geterilambi	[不及]
getuheri	[名]
getuhun	[形]
getukelebumbi	[及]
getukelembi	[及]
getuken	[形]
geye gaya	[副]
geyebumbi	[及]
geyembi	[及]
geyen	[名]
ggabixara	[名]
ggabula	[名]
ggaci	[名]
ggadahadi fusa	[名]
ggalab	[名]
ggaldan	[名]
ggamuliyang	[名]
ggan	[名]
ggan dze	[名]
ggan dzeng cuwan	[名]
ggan je	[名]
ggan lan	[名]
ggan lu	[名]
ggandze	[名]
ggang mu	[名]
ggangga	[名]
ggangtixa	[名]
gganjur	[名]
gganse	[名]
ggaoming	[名]
ggaose	[名]
ggaoyo	[名]
ggaoyoo	[名]
ggarsi	[名]
ggo	[名]
ggodargga	[名]
ggogin	[名]
ggona	[名]
ggonggon	[名]
ggoogin	[名]
gi	[名]
gi dzui	[名]
gi guwan	[名]
gib	[状]
gibaga	[名]
gibagan	[名]
gibaganambi	[不及]
gibalabumbi	[及]
gibalambi	[及]
giban	[名]
gicuhe	[形]
gicuke	[形]
gida	[名]
gidaxabumbi	[不及]
gidaxambi	[及]
gidabun	[名]
gidacan	[名]
gidakv	[名]
gidalabumbi	[不及]
gidalambi	[及]
gidambi	[及]
gidanabumbi	[及]
gidanambi	[及]
gidanjimbi	[及]
gidashvn	[形]
gidu	[名]
gihv	[名]
gihvxambi	[不及]
gihi	[名]
gihintu	[名]
gijan	[名]
gijun	[名]
gijungge	[形]
gikibumbi	[及]
gikimbi	[及]
gilacambi	[及]
gilahvn	[形]
gilajan	[形]
gilajin	[形]
gilbar	[形]
gilembi	[不及]
gilerxembi	[不及]
gilerjembi	[不及]
gilgambi	[及]
gilha	[形]
gili	[名]
giljabumbi	[及]
giljacuka	[形]
giljambi	[及]
giljan	[名]
giljangga	[形]
gilmari	[形]
gilmarjambi	[不及]
gilmarlambi	[不及]
gilmerjembi	[不及]
gilta gilta	[形]
gilta gilti	[形]
giltahvn	[形]
giltarxambi	[不及]
giltari	[形]
giltarilambi	[不及]
giltarjambi	[不及]
giltasikv	[名]
giltugan	[形]
giltuka	[形]
giltukan	[形]
giltungga	[形]
giltusi	[名]
giluk	[名]
gilun	[形]
gimxu	[名]
gimda	[名]
gin	[名]
gin alha	[形]
gin ciyan	[名]
gina	[名]
gincihi	[名]
gincihinembi	[不及]
gincihiyan	[形]
gincihiyari	[形]
gincihiyasaka	[形]
ginciri	[形]
gincitu	[形]
gindana	[名]
ginderhen	[名]
ging	[名]
ging ji	[名]
ginggacun	[形]
ginggambi	[不及]
gingge	[名]
ginggembi	[及]
ginggen	[名]
ginggin	[名]
gingguhe	[名]
gingguji	[名]
ginggulebumbi	[及]
ginggulembi	[及]
ginggulen	[名]
ginggun	[名]
gingkacuka	[形]
gingkambi	[不及]
gingli	[名]
gingnebumbi	[及]
gingnehen	[名]
gingnembi	[及]
gingsimbi	[不及]
ginjule	[名]
gintala	[名]
gintoho	[名]
gintu	[名]
gio	[名]
gioxeri	[名]
giodohon	[名]
giogin	[名]
giogiohon	[形]
giogiyan	[形]
giogiyangga	[形]
giohambi	[不及]
gioho	[名]
giohoxombi	[不及]
giohoto	[名]
gioi	[名]
gioi Rin	[名]
gioi xi	[名]
gioi dzy	[名]
gioingge	[名]
gioise	[名]
gioro	[名]
giose	[名]
giowan	[名]
giowan dze efen	[名]
giowan pen	[名]
giowandze	[名]
giowandzy	[名]
giowanse	[名]
girakv	[名]
giran	[名]
giranggi	[名]
giranggilambi	[不及]
giratu	[名]
giratungga	[形]
girdan	[名]
girdangga	[名]
girdu	[名]
girha	[名]
giri	[名]
giribumbi	[及]
girikv	[名]
girilambi	[及]
girimbi	[及]
girin	[名]
girkvmbi	[及]
giru	[名]
girucuke	[形]
girucun	[名]
girudai	[名]
giruke	[形]
girumbi	[不及]
girungga	[形]
girutu	[形]
gisabumbi	[及]
gisambi	[不及]
gisan	[名]
gise	[名]
gista	[名]
gisucembi	[不及]
gisun	[名]
gisurebumbi	[及]
gisurecembi	[及]
gisurembi	[不及]
gisurembumbi	[及]
gisuren	[名]
gisurendumbi	[不及]
gisurenembi	[不及]
gisurenjimbi	[不及]
gisurenumbi	[不及]
gita loodan	[形]
gituhan	[名]
gituku	[名]
giyvn	[名]
giyvn loo	[名]
giyvn wang	[名]
giya	[名]
giya siyan leke	[名]
giyab giyab	[状]
giyabalabumbi	[及]
giyabalambi	[及]
giyaban	[名]
giyabsahvn	[形]
giyabsarambi	[不及]
giyabumbi	[及]
giyadaraka	[形]
giyaduraka	[形]
giyahvha	[名]
giyahvn	[名]
giyaha	[名]
giyahalacambi	[不及]
giyahalcambi	[不及]
giyahanjambi	[不及]
giyai	[名]
giyai yuwan	[名]
giyajan	[名]
giyaji	[形]
giyakda	[名]
giyakdalambi	[及]
giyakta	[名]
giyaktu	[名]
giyalabumbi	[及]
giyalabun	[名]
giyalakv	[名]
giyalamaha	[名]
giyalambi	[及]
giyalamtun	[名]
giyalan	[名]
giyalatu	[名]
giyalgabumbi	[及]
giyalgambi	[不及]
giyalganjambi	[不及]
giyalhvmbi	[不及]
giyalhanjambi	[不及]
giyalin	[名]
giyaltu	[名]
giyalu	[名]
giyalun	[名]
giyalunambi	[不及]
giyambi	[及]
giyamcan	[名]
giyamuhv	[名]
giyamulabumbi	[及]
giyamulambi	[不及]
giyamun	[名]
giyamusi	[名]
giyan	[名]
giyan xeng	[名]
giyan i hafan	[名]
giyan tiyei	[名]
giyan too	[名]
giyanakv	[形]
giyanceo	[名]
giyancihiyan	[形]
giyang	[名][状]
giyangdu	[名]
giyangga	[形]
giyangguhe	[名]
giyangkv	[形]
giyangkvxambi	[不及]
giyangnabumbi	[及]
giyangnakv	[名]
giyangnakvxambi	[不及]
giyangnambi	[及]
giyangnan	[名]
giyangnandumbi	[及]
giyangnanumbi	[及]
giyangsi	[名]
giyangsimbi	[不及]
giyangsu	[名]
giyantu	[名]
giyapi	[名]
giyapinambi	[不及]
giyar gir	[状]
giyar giyar	[状]
giyarga	[名]
giyargiyan	[状]
giyaribumbi	[及]
giyarici	[名]
giyarimbi	[及][不及]
giyarimsi	[名]
giyarinambi	[不及]
giyarinjimbi	[不及]
giyase	[名]
giyatarambi	[及]
giyei tiyei	[名]
giyei ucuri	[名]
giyen	[名]
giyengge	[名]
giyo	[名]
giyob	[状]
giyobgiya	[名]
giyogiyan	[名]
giyoholombi	[不及]
giyok	[状]
giyolo	[名]
giyomo	[名]
giyong	[状]
giyoo	[名]
giyoo si	[名]
giyoocan	[名]
giyor	[状]
giyoro	[名]
giyorobumbi	[及]
giyorombi	[不及]
giyos	[状]
giyose	[名]
giyowan	[名]
go	[名]
gobi	[名]
gobolobumbi	[及]
gobolombi	[不及]
goci tata	[形]
gocibumbi	[及]
gocikv	[名]
gocika	[形]
gocikangga	[形]
gocima	[名]
gocimbi	[及]
gocimbumbi	[及]
gocingga	[形]
gocishvdambi	[不及]
gocishvn	[名]
gocisun	[名]
godohon	[形]
godombi	[不及]
godomimbi	[不及]
godondumbi	[不及]
godonumbi	[不及]
godor	[状]
gofoho	[名]
gofoholombi	[不及]
gofoloko	[名]
gofolombi	[不及]
goho	[形]
gohoxombi	[不及]
gohodombi	[及][不及]
goholombi	[及]
gohon	[名]
gohonggo	[形]
gohorokongge	[形]
gohorombi	[不及]
gohoto	[名]
goibumbi	[不及]
goicuka	[形]
goicukangge	[形]
goidaxambi	[不及]
goidabumbi	[及]
goidambi	[不及]
goihorombi	[不及]
goiman	[名]
goimangga	[形]
goimarambi	[不及]
goimbi	[不及]
goito	[名]
goji	[名]
gojime	[连]
gojingga	[形]
gojinggi	[形]
gojong	[状]
gojor	[状]
gokci	[名]
gokcingge	[形]
gokji	[名]
gokjibumbi	[及]
gokjimbi	[不及]
goko	[状]
goksi	[名]
golafungga	[形]
golambi	[不及]
golbon	[名]
golcehen	[形]
golderen	[名]
golmika	[形]
golmikan	[形]
golmin	[形]
golmingga	[形]
golmishvn	[形]
golmitu	[名]
golo	[名]
golocun	[名]
golohon	[名]
golohongge	[形]
golohonjombi	[不及]
golombi	[不及]
golon	[名]
golondumbi	[不及]
golonggo	[形]
golonombi	[不及]
golonumbi	[不及]
golorombi	[不及]
golotome	[副]
golotome simnembi	[不及]
golton	[名]
gombi	[不及]
gon gan	[状]
gonggibumbi	[及]
gonggimbi	[及]
gonggohon	[形]
gonggohori	[形]
gonggon	[名]
gonggori	[形]
gonjambi	[不及]
gorgi	[名]
gorgin	[名]
goro	[形][名]
goroki	[名]
gorokin	[名]
gorokingge	[形]
gorokon	[形]
goromimbi	[及]
gorongge	[形]
gosibumbi	[及]
gosicuka	[形]
gosicungga	[形]
gosihvn	[形]
gosiholombi	[不及]
gosihon	[形]
gosihori	[名]
gosimbi	[及]
gosin	[名]
gosindumbi	[及]
gosingga	[形]
gu	[名]
gu Rung	[名]
gu niyang	[名]
gu pai	[名]
guHang	[名]
gub	[状]
gubci	[形][后]
gubcingge	[形]
gubsu	[名]
gubulembi	[不及]
guceng	[名]
gucihi	[名]
gucihiyerambi	[及]
gucihiyereku	[名]
gucihiyerembi	[及]
gucihiyerendumbi	[及]
gucihiyerenumbi	[及]
gucu	[名]
guculembi	[不及]
gudexembi	[不及]
gudzy	[名]
gufan	[名]
gufu	[名]
gugu gugu	[状]
gugui	[名]
gugun	[名]
gugur	[状]
gugurxembi	[不及]
gugurcembi	[不及]
gugurembi	[不及]
guhvtun	[名]
guhe	[名]
guheren	[形]
gui	[名]
gui Rin	[名]
gui dzui	[名]
gui fui	[名]
gui hai	[名]
gui jeo	[名]
guifun	[名]
guigu	[形]
guikeri	[名]
guilebumbi	[及]
guilehe	[名]
guilembi	[及]
guilendumbi	[及]
guilenjimbi	[及]
guilenumbi	[及]
guileri	[名]
guini	[名]
guioi	[名]
guise	[名]
gujehe	[名]
gujiri	[形]
gujiri ilha	[名]
gujung	[状]
gukdu gakda	[状]
gukduhun	[形]
gukdun	[形]
gukdurembi	[不及]
guki	[名]
gukio	[名]
gukiong	[名]
gukse	[名]
guksen	[名]
guksu	[名]
gukubumbi	[及]
gukubun	[名]
gukumbi	[不及]
gukung	[名]
gukunggele	[副]
gulan	[名]
gulbu	[名]
gulejembi	[不及]
gulhuken	[形]
gulhun	[形]
guli juxen halangga niyalma	[名]
gulin	[名]
guliya tun	[名]
gulu	[形]
guluken	[形]
gulung	[状]
gun	[名]
gun xui ba dalan	[名]
gunda	[名]
gung	[名]
gungxi	[名]
gungceo	[名]
gungcu	[名]
gungcun	[名]
gungdze	[名]
gungdzu	[名]
gungge	[名]
gunggu	[名]
gunggucembi	[不及]
gungguhun	[形]
gunggulembi	[不及]
gunggulu	[名]
gunggulun	[形]
gunggulungge	[形]
gunggumbi	[不及]
gunggun ganggan	[形]
gunggung	[名]
gunghun	[名]
gungju	[名]
gungkeri	[名]
gungnebumbi	[及]
gungnecuke	[形]
gungnecun	[名]
gungnembi	[不及]
gunirembi	[不及]
guniyerembi	[不及]
gur	[状]
gure	[名]
gurehe	[名]
gurehedembi	[不及]
gurehelebumbi	[及]
gurehelembi	[及]
gurelji	[名]
gurembi	[及]
gurgu	[名]
gurgungge	[形]
gurgutu	[名]
guribumbi	[及]
gurimbi	[不及]
gurinembi	[不及]
gurinjembi	[不及]
gurinjimbi	[不及]
guriwa	[名]
gurjen	[名]
gurlun	[名]
gurubumbi	[不及]
gurumbi	[及]
gurun	[名]
gurunambi	[及]
gurunembi	[及]
gurung	[名]
gurunumbi	[不及]
guse	[名]
gusha	[名]
gushembi	[不及]
gusherakv	[形]
gusimen	[名]
gusucembi	[不及]
gusucuke	[形]
gusucumbi	[不及]
guwa	[名]
guwafu	[名]
guwaige	[名]
guwalase	[名]
guwalasun	[名]
guwali	[名]
guwan	[名]
guwan xa usiha	[名]
guwan endun	[名]
guwan fang	[名]
guwan in	[名]
guwandi	[名]
guwandzy	[名]
guwang	[名]
guwangxa	[名]
guwangdung	[名]
guwangga	[形]
guwangguxambi	[不及]
guwanggun	[名]
guwangse	[名]
guwangselambi	[不及]
guwangsi	[名]
guwanni	[形]
guwase	[名]
guwatalambi	[不及]
guwebuhen	[名]
guwebumbi	[及]
guweciheri	[形]
guwedebumbi	[及]
guwejihe	[名]
guwekembi	[及]
guwele	[形]
guwelecembi	[不及]
guweleku	[名]
guwelkembi	[及]
guwembi	[不及]
guwembumbi	[及]
guwendehen	[名]
guwendembi	[不及]
guwenden	[形]
guwendengge	[形]
guwendumbi	[不及]
guye	[名]
guyoo	[名]
hv	[名]
hvxa	[名]
hvxahv	[名]
hvxaju	[名]
hvba	[名]
hvbalambi	[及]
hvban	[名]
hvbarak	[名]
hvberi	[名]
hvbixambi	[及]
hvbilabumbi	[不及]
hvbilgan	[名]
hvbin	[名]
hvbumbi	[不及]
hvcin	[名]
hvda	[名]
hvdaxabumbi	[及]
hvdaxambi	[不及]
hvdukan	[形]
hvdulabumbi	[及]
hvdulambi	[及]
hvdun	[形]
hvfan	[名]
hvfubumbi	[不及]
hvfun	[名]
hvguwang	[名]
hvhvba	[名]
hvhvli	[名]
hvha	[名]
hvi	[名][副][状]
hvi xoro	[名]
hvi giowan	[名]
hvi hiyang	[名]
hvi kui	[名]
hvi yuwan	[名]
hvjaci	[名]
hvjibumbi	[及]
hvjiri	[名]
hvk	[状]
hvkcumbi	[及]
hvkjun	[名]
hvktambi	[不及]
hvktambumbi	[及]
hvlaxambi	[及]
hvlabumbi	[及]
hvlan	[名]
hvlanabumbi	[及]
hvlanambi	[及]
hvlandumbi	[及]
hvlangga	[形]
hvlanjimbi	[及]
hvlanumbi	[及]
hvlgican	[形]
hvlha	[名]
hvlhabumbi	[不及]
hvlhanambi	[及]
hvlhandumbi	[及]
hvlhanjimbi	[不及]
hvlhanumbi	[及]
hvlhatu	[名]
hvlhi	[名]
hvlhidambi	[不及]
hvlhikan	[形]
hvlhitu	[名]
hvlibun	[名]
hvlimbumbi	[不及]
hvluri malari	[副]
hvman	[名]
hvmarbumbi	[不及]
hvmbi	[及]
hvmbur	[状]
hvnambi	[不及]
hvncihin	[名]
hvng	[形][状]
hvngniyoolambi	[不及]
hvngsi	[名]
hvngsitambi	[及]
hvngsitu	[形]
hvnta	[名]
hvntahan	[名]
hvntung	[名]
hvr	[状]
hvrfu	[名]
hvrga	[名]
hvrgikv	[名]
hvrha	[形][名]
hvrhadabumbi	[及]
hvrhadambi	[及]
hvrhan	[名]
hvri	[名]
hvrka	[名]
hvru	[名]
hvrubumbi	[及]
hvrudambi	[及]
hvse	[名]
hvsetai	[形]
hvshvri coko	[名]
hvsha monggon	[名]
hvsiba	[名]
hvsibumbi	[不及]
hvsiha	[名]
hvsihan	[名]
hvsikv	[名]
hvsimbi	[及]
hvsime	[名]
hvsingga	[形]
hvsiri	[形]
hvsitun	[名]
hvsun	[名]
hvsungge	[形]
hvsuri	[名]
hvsutulebumbi	[及]
hvsutulembi	[不及]
hvturi	[名]
hvturingga	[形]
hvwa	[名]
hvwaxabukv	[名]
hvwaxabumbi	[及]
hvwaxada	[名]
hvwaxambi	[不及]
hvwaxan	[名]
hvwacarambi	[不及]
hvwacihiyan enggemu	[名]
hvwafihiya	[名]
hvwafihiyabumbi	[及]
hvwafihiyambi	[及]
hvwai	[名][状]
hvwaise	[名]
hvwaitambi	[及]
hvwaitame	[形]
hvwajambi	[不及]
hvwajiyoo	[名]
hvwakxahalambi	[及]
hvwakxahan	[名]
hvwakxan	[名]
hvwakiyambi	[及]
hvwalambi	[及]
hvwalame	[形]
hvwalar	[状]
hvwaliyambi	[不及]
hvwaliyambumbi	[及]
hvwaliyan	[名]
hvwaliyandumbi	[不及]
hvwaliyapi	[形]
hvwaliyasun	[形]
hvwamiyambi	[及]
hvwang	[形][名]
hvwangdana	[名]
hvwangdi	[名]
hvwangga	[形]
hvwanggar	[状]
hvwanggiyambi	[不及]
hvwanggiyan	[名]
hvwangheo	[名]
hvwangli	[名]
hvwanta	[形]
hvwantahvn	[形]
hvwar	[状]
hvwara	[名]
hvwarabumbi	[不及]
hvwaradambi	[及]
hvwarakan	[名]
hvwarambi	[及]
hvwasa hisa	[状]
hvwasar	[状]
hvya	[名]
hvyambi	[不及]
hvyan	[名]
hvyanambi	[不及]
hvyasun	[名]
hvyuxembi	[及]
hvyukv xoro	[名]
ha	[名][状]
haxa	[名]
haxabumbi	[及]
haxahan	[名]
haxakv	[名]
haxambi	[及]
haxan	[名]
haxatambi	[及]
haxukv	[名]
habxambi	[及]
habxan	[名]
habxanambi	[及]
habxandumbi	[及]
habxanjimbi	[及]
habcihiyadambi	[不及]
habcihiyan	[形]
habgiyambi	[不及]
habta	[名]
habtaxambi	[及]
habtaha	[名]
habtalambi	[及]
habtambi	[及]
haca	[名]
hacihiyambi	[及]
hacihiyan	[名]
hacihiyanambi	[及]
hacihiyandumbi	[及]
hacihiyanjimbi	[及]
hacihiyanumbi	[及]
hacika	[名]
hacilambi	[及]
hacin	[名]
hacingga	[形]
hacuhan	[名]
hacuhiyan	[名]
hacuka	[形]
hacukadambi	[不及]
hacumbi	[不及]
hada	[名]
hadafun	[及]
hadagan	[及]
hadaha	[及]
hadahan	[名]
hadai	[名]
hadala	[名]
hadama	[名]
hadara	[名]
hadatu	[名]
hadubumbi	[及]
hadufun	[名]
haduhvn	[形]
hadumbi	[及]
hadunambi	[及]
hadunjimbi	[及]
hadunumbi	[及]
hafa	[名]
hafan	[名]
hafasi	[名]
hafixambi	[及]
hafixangga	[形]
hafin	[名]
hafirxabumbi	[及]
hafirxambi	[及]
hafirxanumbi	[及]
hafirahvn	[形]
hafirakv	[名]
hafirambi	[及]
hafirhvn	[形]
hafitambi	[及]
hafu	[形][后][副]
hafukiyambi	[及]
hafulambi	[不及]
hafumbi	[不及]
hafumbubumbi	[及]
hafumbukv	[名]
hafumbumbi	[及]
hafun	[名]
hafunambi	[不及]
hafundambi	[不及]
hafungga	[形]
hafunjimbi	[不及]
hafuri	[形]
haga	[名]
hagabukv	[名]
hagambi	[不及]
hahvbumbi	[不及]
hahvmbi	[不及]
hahvrxambi	[及]
hahvrakv	[名]
hahvrambi	[及]
haha	[形]
hahabukv	[名]
hahama	[名]
hahambi	[不及]
hahangge	[形]
haharame	[副]
hahardambi	[不及]
hahi	[形]
hahiba	[形]
hahikan	[形]
hahilambi	[不及]
haicing	[名]
haidan	[名]
haidarxambi	[不及]
haidarabumbi	[及]
haidarambi	[不及]
haidu	[形]
haifixambi	[及]
haifirxambi	[及]
haigv	[形]
haigari	[形]
haihv	[形]
haihvljambi	[不及]
haihvn	[名]
haihvna	[名]
haihvngga	[形]
haihvwa	[名]
haihvwan	[形]
haiha	[名]
haihabumbi	[及]
haihaljambi	[不及]
haihan	[名]
haiharxambi	[不及]
haiharambi	[不及]
haiharame	[副]
haihashvn	[形]
haijan	[名]
haijung	[状]
hailambi	[不及]
hailami	[名]
hailan	[名]
hailashvn	[形]
hailun	[名]
hairabumbi	[及]
hairacuka	[形]
hairacun	[名]
hairaka	[叹]
hairakan	[叹][形]
hairambi	[及]
hairan	[名]
hairandambi	[及]
haisanda	[名]
haita	[名]
haitang	[名]
hajan	[名]
haji	[形]
hajilambi	[不及]
hajilan	[名]
hajin	[名]
hajingga	[形]
hajingge	[形]
hajun	[名]
hak	[状]
hakxambi	[及]
hakxan	[名]
hakambi	[不及]
hakcin	[名]
hakda	[名]
haksambi	[不及]
haksan	[形]
haksangga	[形]
hala	[名]
halaxakv	[名]
halaxambi	[不及]
halabumbi	[不及]
halahai	[名]
halaitu	[名]
halambi	[及][不及]
halan	[名]
halandumbi	[及]
halangga	[形]
halanjambi	[不及]
halanjimbi	[不及]
halanumbi	[及]
halar	[状]
halba	[名]
halbaha	[名]
halbahan	[名]
halbixambi	[不及]
halbuhan	[名]
halbulha	[名]
halbumbi	[及]
halda	[名]
haldaba	[名]
haldabaxambi	[不及]
haldarambi	[不及]
halfiri	[名]
halfiyakan	[形]
halfiyan	[形]
halfiyangga	[形]
halgan	[名]
halgimbi	[及]
halhvkan	[形]
halhvn	[形]
halhvri	[名]
halhan	[名]
halhimbi	[及]
halhime	[名]
hali	[名]
halman	[名]
halmari	[名]
halmun	[名]
halnambi	[不及]
haltan	[名]
halu	[名]
halukv	[名]
halukan	[形]
halukasaka	[形]
halungga	[形]
hamgiya	[名]
hamgiyari	[名]
hami	[名]
hamixambi	[不及]
hamimbi	[不及]
haminambi	[不及]
haminjimbi	[不及]
hamirembi	[不及]
hamtakv	[名]
hamtambi	[不及]
hamtanambi	[不及]
hamu	[名]
hamutambi	[不及]
han	[名]
han dung	[名]
hana	[名]
hanci	[形][后]
hancikan	[形]
hanciki	[形]
hancikingge	[形]
hancingga	[形]
hancingge	[形]
handa	[名]
handu	[名]
handucun	[名]
handutun	[名]
hangxara	[名]
hanggai	[名]
hanggambi	[及]
hanggi	[名]
hanggir	[状]
hanggisun	[名]
hangki	[名]
hangnambi	[及]
hangnan	[名]
hangnasi	[名]
hangse	[名]
hangsi	[名]
hanja	[形]
hanjadambi	[不及]
hanjambi	[不及]
hanjan	[名]
har	[形]
harxakv	[名]
harxambi	[及]
harxandumbi	[及]
harxanumbi	[及]
hara	[名]
haran	[名][后]
haranambi	[不及]
harangga	[代][名]
haratu	[名]
hardakv	[名]
hardambi	[及]
harga	[及]
hargaxambi	[及]
hargaxan	[名]
hargaxandumbi	[及]
hargaxanjimbi	[及]
hargaxanumbi	[及]
hargasi	[名]
hargi	[名]
harhv	[名]
harhvdambi	[及]
harha	[名]
hari	[形]
harikv	[名]
harima	[形]
harimbi	[及]
harkasi	[名]
harsa	[名]
hartungga	[名]
harun	[及]
hasa	[副]
hasaha	[名]
hasahangga	[形]
hasak	[名][状]
hasala	[名]
hasalabumbi	[及]
hasalakv	[名]
hasalambi	[及]
hasan	[名]
hasanahangge	[形]
hasanambi	[不及]
hashv	[名]
hashvtai	[形]
hasha	[名]
hashalambi	[及]
hashan	[名]
hasi	[名]
hasiba	[形]
hasihan	[名]
hasihimbi	[不及]
hasima	[名]
hasingga	[形]
hasiri	[形]
hasrun sirga	[名]
hasu orho	[名]
hasukiyalambi	[及]
hasuralabumbi	[及]
hasuralambi	[及]
hasuran	[名]
hasurgalambi	[及]
hasutai	[形]
hata	[名]
hatabumbi	[及]
hataburu	[形]
hatacuka	[形]
hatakan	[形]
hatambi	[及]
hatan	[名]
hatarambi	[不及]
hatuhvn	[形]
hayabumbi	[及]
hayadambi	[不及]
hayahan	[名]
hayakta	[名]
hayaljambi	[不及]
hayan	[形]
hayandambi	[不及]
hayarilambi	[不及]
hayarlambi	[不及]
he	[名]
he fa	[状]
he gi	[名]
hexelembi	[及]
hexemilambi	[及]
hexemimbi	[及]
hexen	[名]
hexenembi	[不及]
hexu haxu	[形]
hexurembi	[及]
hebdexembi	[及]
hebdembi	[及]
hebdenembi	[及]
hebdenjimbi	[及]
hebe	[名]
hebexebumbi	[及]
hebexembi	[及]
hebedembi	[不及]
hebengge	[形]
hebte	[形]
hebtexembi	[不及]
hebtehe	[名]
hebtenio	[名]
hebu	[名]
hebunembi	[不及]
hecebumbi	[及]
hecembi	[及]
hecen	[名]
heceri	[名]
hede	[名]
hedei	[名]
hederebumbi	[及]
hedereku	[名]
hederembi	[及]
hederenumbi	[及]
hedu	[名]
hefeli	[名]
hefeliye	[名]
hefeliyebumbi	[及]
hefeliyembi	[及]
hefeliyenembi	[不及]
hehe	[形]
heherdembi	[不及]
hehereku	[形]
heherembi	[不及]
heheri	[名]
hei hai	[状]
heiharilambi	[不及]
heihedembi	[不及]
heiherembi	[不及]
heiheri	[形]
heiherilembi	[不及]
heihule	[名]
heihuwe	[名]
hejefiyaha	[名]
hejembi	[不及]
hejihe	[名]
hejihelembi	[及]
hekcehun	[形]
hekcembi	[不及]
hekderembi	[不及]
hekderhen	[名]
hekderhun	[形]
hekterebumbi	[及]
hekterembi	[不及]
hele	[名]
heledembi	[不及]
helen	[名]
heleri halari	[状]
helfixembi	[不及]
heliyen	[名]
helme	[名]
helmexembi	[不及]
helmehen	[名]
helmeku	[名]
helmembi	[不及]
helmen	[名]
helmenembi	[不及]
helnebumbi	[及]
helnembi	[及]
hemhimbi	[不及]
hemilembi	[及]
hemkimbi	[不及]
hempe	[名]
hen	[形][名]
hencehen	[名]
henceku	[名]
hencembi	[及]
hendumbi	[不及]
hengge	[名]
henggenembi	[不及]
hengke	[名]
hengkeri	[名]
hengkixembi	[不及]
hengkidembi	[不及]
hengkileku	[名]
hengkilembi	[不及]
hengkilendumbi	[不及]
hengkilenembi	[不及]
hengkilenjimbi	[不及]
hengkilenumbi	[不及]
hengkin	[名]
heni	[形][名]
henjembi	[及]
henjimbi	[及]
henjinjimbi	[及]
hente	[名]
hentelembi	[及]
heo	[名][状]
heoxembi	[不及]
heoledembi	[不及]
heolen	[名]
heolendembi	[不及]
heperebumbi	[不及]
heperembi	[及][不及]
her har	[副][状]
herxembi	[及]
hercimbi	[及]
hercun	[名]
herdembi	[不及]
herebumbi	[及]
hereku	[名]
herembi	[及]
heren	[名]
heresu	[名]
hergebumbi	[及]
hergembi	[及]
hergen	[名]
hergenembi	[及]
hergengge	[形]
hergesi	[名]
hergice	[名]
hergin	[名]
hergitu	[名]
herin	[名]
heristos	[名]
hersembi	[及]
heru	[名]
hese	[名]
hesebumbi	[不及]
hesebun	[名]
hesihe	[名]
hesihexembi	[不及]
hesihedembi	[不及]
hesihenembi	[及]
hesihetembi	[不及]
hesitembi	[不及]
hetehen	[名]
hetge	[名]
hethe	[名]
hethembi	[及]
hetu	[形][副]
hetuken	[形]
hetuliyan	[形]
hetumbi	[不及]
hetumbumbi	[及]
heturembi	[及]
heturen	[名]
heturhen	[名]
heturi	[形]
heye	[名]
heyen	[名]
heyenembi	[不及]
hi cy	[名]
hib	[状]
hibcan	[名]
hibcarambi	[及]
hibcarandumbi	[及]
hibcaranumbi	[及]
hibsu	[名]
hibsungge	[形]
hibta	[名]
hican	[形]
hicu	[名]
hicumbi	[及]
hida	[名]
hidakv	[名]
hidambi	[及]
hife	[名]
hihvn budun	[形]
hihalambi	[及]
hihan	[形]
hihanakv	[名]
hija	[名]
hijada	[名]
hilteri	[名]
hilterilembi	[及]
himci	[副]
hin giranggi	[名]
hina	[名]
hing	[状]
hinggan	[名]
hinggari	[名]
hingge	[名]
hinggeri	[名]
hingkan	[名]
hingke	[形]
hingneci	[名]
hingsengge	[形]
hio	[状]
hiong	[状]
hionghioi	[形]
hiowan yei	[名]
hir	[状]
hiracambi	[及]
hirambi	[及]
hirgen	[名]
hirhvmbi	[不及]
hirha	[名]
hirhambi	[及]
hiri	[副]
hirihvn	[形]
hirinjambi	[不及]
hisalabumbi	[及]
hisalambi	[及]
hisdakv	[名]
hise	[名]
hishvn	[形]
hishabumbi	[及]
hishakv	[名]
hishambi	[及]
hishame	[后]
hishan	[名]
hishanambi	[不及]
hisy	[名]
hitahvxambi	[及]
hitahvn	[名]
hiterexembi	[不及]
hiterebumbi	[及]
hiterembi	[不及]
hiterenembi	[不及]
hitha	[名]
hithalambi	[及]
hithari	[名]
hithembi	[及]
hithen	[名]
hiya	[形][名]
hiyab	[状]
hiyaban	[名]
hiyabsa	[名]
hiyabsalambi	[及]
hiyabsambi	[及]
hiyabulakv	[名]
hiyabun	[名]
hiyadabumbi	[及]
hiyadambi	[及]
hiyadan	[名]
hiyadangga	[形]
hiyaganjambi	[不及]
hiyahv	[形]
hiyahalabumbi	[不及]
hiyahalambi	[及]
hiyahali	[形]
hiyahali cecike	[不及]
hiyahambi	[不及]
hiyahan	[名]
hiyahanjambi	[不及]
hiyajuhu nimaha	[名]
hiyak	[状]
hiyakanjambi	[不及]
hiyalambi	[及]
hiyalhvwa	[名]
hiyalhvwari	[名]
hiyalu	[名]
hiyaluri	[形]
hiyamtun	[名]
hiyan	[名]
hiyan an gung	[名]
hiyanci	[名]
hiyancilambi	[不及]
hiyang	[状]
hiyang cvn	[名]
hiyangci	[名]
hiyangnung alin	[名]
hiyangtarxambi	[不及]
hiyangtu	[形]
hiyari	[形]
hiyaribumbi	[不及]
hiyase	[名]
hiyaseku	[名]
hiyatahan	[名]
hiyatari	[名]
hiyatu	[名]
hiyatun	[名]
hiyebele	[名]
hiyekden moo	[名]
hiyena	[名]
hiyenakv	[形]
hiyese	[名]
hiyob	[状]
hiyok	[状]
hiyong	[状]
hiyooxulambi	[及]
hiyooxun	[名]
hiyooxungga	[形]
hiyooxuntumbi	[不及]
hiyooxuri	[形]
hiyor	[状]
hiyotohon	[形]
hiyotonggo	[形]
hiyotorxombi	[不及]
hiyotorobumbi	[及]
hiyotorombi	[及]
ho bira	[名]
ho gi	[名]
ho ha	[状]
ho hoi	[状]
ho lan	[名]
hoxxombi	[及]
hoxo	[名]
hoxoxombi	[及]
hoxoi	[名]
hoxon	[名]
hoxonggo	[形]
hoxotolombi	[及]
hoxotonggo	[形]
hob	[状]
hobai	[形]
hobo	[名]
hobolon	[名]
hoborho	[名]
hocikon	[形]
hocikosaka	[形]
hodan gasha	[名]
hode	[副]
hodori	[名]
hodzy	[名]
hofin	[名]
hofiyan	[形]
hofun	[名]
hoho	[名]
hohoco	[形]
hohocu	[名]
hohodokv	[名]
hohodombi	[及]
hohon	[名]
hohonggo	[形]
hohonombi	[不及]
hohonto	[名]
hohori	[名]
hoi	[副]
hoifa	[名]
hoifalambi	[及]
hoifan	[名]
hoihalambi	[不及]
hoihan	[名]
hoiho	[名]
hoilacambi	[及]
hoilalambi	[及]
hoilambi	[不及]
hoilantu	[名]
hoilashvn	[形]
hoise	[名]
hojihon	[名]
hojiko	[名]
hojikosaka	[副]
hojiri	[形]
hojo	[形]
hojon	[形]
hokci	[名]
hoki	[名]
hokilambi	[不及]
hokobumbi	[及]
hoksombi	[不及]
hoktoxombi	[不及]
hokton	[名]
holbohon	[名]
holbon	[名]
holbonggo	[形]
holboto	[形]
holdon	[名]
holhoci	[名]
holhon	[名]
holimpa	[名]
holin	[名]
holkon de	[副]
holkonde	[副]
holo	[形][名]
holokon	[形]
holon gaha	[名]
holon weijun	[名]
holontu	[名]
holor	[状]
holtombi	[不及]
holton	[名]
holtonumbi	[不及]
holtu	[形]
homhon	[名]
homida	[形]
homin	[名]
homitu	[形]
homso	[名]
homsori	[形]
hon	[副]
honan	[名]
honci	[名]
hondoba	[名]
hong taiji	[名]
honggoco	[名]
honggocon	[名]
honggolon	[形]
honggon	[名]
honggono	[形]
honggonombi	[不及]
honggori	[名]
hongko	[名]
hongkolo	[形]
hongtu	[形]
honika	[名]
honiki	[名]
honin	[名]
honingga	[形]
hono	[连][副]
honokta	[名]
hontoho	[名]
hontoholombi	[及]
hoo	[名][状]
hoo ban	[名]
hooxan	[名]
hooxari	[形]
hoohan	[名]
hor	[状]
horgikv	[名]
horgimbi	[及]
horgin	[名]
horho	[名]
horhotu	[名]
horibumbi	[不及]
horigan	[名]
horilakv	[形]
horimbi	[及]
horin	[名]
horki	[名]
hormosda	[名]
horo	[名]
horoki	[形]
horolombi	[不及]
horon	[名]
horongge	[形]
horonggo	[形]
horontu	[形]
hosan	[形]
hose	[名]
hoseri	[名]
hoshori	[形]
hoshorilambi	[及]
hoshorinambi	[不及]
hoshorinombi	[及]
hoso hasa	[状]
hosori	[名]
hoto	[形][名]
hotoci	[名]
hotohon	[形]
hotombi	[不及]
hoton	[名]
hotorombi	[不及]
hubtu	[名]
hude	[名]
huhu	[形][名]
huhucu	[名]
huhun	[名]
huhuri	[形]
huingge malu	[名]
hujengge	[形]
huju	[名]
hujuku	[名]
hujumbi	[及][不及]
hujureku	[名]
hujuri	[名]
hukxembumbi	[及]
hukxen	[形]
hukxenumbi	[不及]
hukxeri	[形]
hukxumbi	[不及]
huksidembi	[不及]
huktu	[名]
hukun	[名]
hule	[名]
hulun buir	[名]
hulun murakv	[名]
humxe	[名]
humsuhun	[名]
humsun	[名]
humudu	[名]
huncu	[名]
huncun	[名]
hundu	[形]
hunehe	[名]
hung li	[名]
hungken	[名]
hungkimbi	[及]
hunio	[名]
hunuhu	[及]
hurcembi	[及]
huren	[名]
hurgen	[名]
hurhui	[形]
hurku	[名]
hurkun	[形]
hurse	[名]
huru	[名]
hurugan	[名]
hurungge	[形]
huterembi	[不及]
huthe	[名]
huthenembi	[不及]
huthubumbi	[及]
huthumbi	[及]
hutu	[名]
hutungge	[形]
huwexeku	[名]
huwexembi	[及]
huwexen	[名]
huwejebumbi	[及]
huwejehen	[名]
huwejehengge	[形]
huwejembi	[及]
huwejen	[名]
huwejengge	[形]
huweki	[形]
huwekiyebumbi	[及]
huwekiyebun	[名]
huwekiyembi	[不及]
huwekiyen	[名]
huwekiyendumbi	[不及]
huwekiyenumbi	[不及]
huwengge	[形]
huwengkiyembi	[及]
huwenji	[名]
huwerke	[名]
huwesi	[名]
huwesixembi	[及]
huwesilembi	[及]
huweten	[名]
huwethi	[名]
huye	[名]
i	[代][名]
i ci	[叹]
i i	[状]
i ju	[名]
iaihvwa	[名]
iaihutdtu	[名]
iakcan	[名]
iakiyambi	[及]
ialimbi	[不及]
iamurcan	[名]
iangca	[名]
iashatai	[副]
iatunjimbi	[不及]
ibadan	[名]
ibagaxambi	[不及]
ibagan	[名]
ibahaxambi	[不及]
ibahan	[名]
ibakabumbi	[及]
ibakambi	[及]
ibakci	[名]
ibexembi	[不及]
ibedembi	[不及]
ibeden	[名]
ibehen	[名]
ibembi	[不及]
ibenembi	[不及]
ibenumbi	[不及]
iberi	[名]
ibete	[名]
ibiri	[名]
ibiyaburu	[名]
ibiyacun	[形]
ibiyada	[形]
ibiyaha	[名]
ibiyahalambi	[不及]
ibiyambi	[不及]
ibiyon	[形]
ibkaxambi	[不及]
ibkabumbi	[及]
ibkambi	[及]
ibte	[名]
ibtenembi	[不及]
iburxambi	[不及]
ica	[名]
icakv	[形]
icakvxambi	[不及]
icakvliyan	[形]
icangga	[形]
icanggangge	[名]
ice	[形]
icebumbi	[不及]
icebun	[名]
iceken	[形]
icekesaka	[形]
iceku	[名]
iceleme	[后]
icembi	[及]
icemlembi	[及]
icengge	[形]
icereme	[形]
ici	[名][方][后]
icixambi	[不及]
icihi	[名]
icihiyabukv	[名]
icihiyambi	[及]
icihiyandumbi	[不及]
icihiyanjambi	[不及]
icihiyantu	[名]
icihiyanumbi	[不及]
icihiyasi	[名]
icikvxabumbi	[不及]
icingga	[形]
icitai	[名]
icu	[名]
idambi	[不及]
idarxambi	[不及]
idarambi	[不及]
idu	[名]
idukan	[名]
idumbi	[及]
idun	[名]
idurabumbi	[及]
idurambi	[不及]
idurembi	[不及]
ifimbi	[及]
ifin	[名]
igan	[名]
igehe	[名]
igen	[名]
igeri	[名]
ihaci	[名]
ihan	[名]
ihangga	[形]
ihasi	[名]
ihasingga	[形]
ihida	[名]
ija	[名]
ijarxambi	[不及]
ijari	[形]
ijarlambi	[不及]
ijasha	[形]
ijifun	[名]
ijilabumbi	[及]
ijilambi	[不及]
ijilembi	[不及]
ijimbi	[及]
ijin	[名]
ijintu	[名]
ijirxembi	[不及]
ijirhi	[名]
ijishvn	[名]
ijumbi	[及]
ijurxambi	[及]
ijurabumbi	[不及]
ijurambi	[及]
ikvmbi	[不及]
ikvn	[名]
ikvrxambi	[不及]
ikvrsun	[名]
ikdaki	[名]
ikengge	[形]
ikiri	[形]
ikirilame	[名]
iktambi	[及]
iktan	[名]
iktangga	[形]
ilacambi	[不及]
ilaci	[数]
ilacingge	[数]
iladambi	[不及]
ilafibumbi	[及]
ilafimbi	[及]
ilagvri	[形]
ilagi	[名]
ilaha	[名]
ilambi	[不及]
ilan	[数]
ilanggeri	[数]
ilanofi	[数]
ilari	[名]
ilarsu	[名]
ilata	[数]
ilbaxambi	[不及]
ilbabumbi	[不及]
ilbakv	[名]
ilbambi	[及]
ilban	[名]
ilbarilambi	[不及]
ilbeke	[形]
ildamu	[形]
ildamungga	[形]
ildedei	[名]
ildefun	[名]
ildehe	[名]
ilduxambi	[不及]
ildubi	[名]
ildubumbi	[及]
ildufun	[名]
ildumbi	[不及]
ildun	[名]
ildungga	[形]
ile	[名]
ilebumbi	[及]
ilembi	[及]
ilenggu	[名]
ilerebumbi	[及]
ilerembi	[及]
iletu	[及]
iletuken	[形]
iletulebumbi	[及]
iletulehen	[名]
iletulembi	[及]
iletun	[名]
iletungge	[形]
iletusaka	[形]
ilga	[名]
ilgaxambi	[不及]
ilgaxanambi	[不及]
ilgabumbi	[不及]
ilgabun	[名]
ilgacun	[名]
ilgambi	[及]
ilganambi	[不及]
ilgandumbi	[及]
ilgangga	[形]
ilgari	[名]
ilgin	[名]
ilgiri	[形]
ilhv	[形]
ilhvngga	[形]
ilha	[名]
ilhakv	[形]
ilhamuke	[名]
ilhanambi	[不及]
ilhangga	[形]
ilhanggangge	[名]
ilhari	[名]
ilhi	[形][名]
ilhin	[形]
ilhinembi	[不及]
ilhuru	[名]
ili	[名]
ilibumbi	[及]
ilibunjimbi	[及]
ilicambi	[不及]
ilifimbi	[不及]
ilihai	[副]
ilihangga	[形]
ilihen	[名]
ilimbahambi	[不及]
ilimbi	[及]
ilimeliyan	[形]
ilin	[名]
ilinambi	[不及]
ilingga	[形]
ilinjambi	[不及]
ilinjimbi	[不及]
ilkidun	[名]
ilmahv	[名]
ilmaha	[名]
ilmen	[名]
ilmerembi	[不及]
ilmoho	[形]
ilmun	[名]
iltajambi	[不及]
ilten	[名]
ilweri	[名]
ilyoodz	[名]
imahv	[名]
imalan	[名]
imari	[名]
imata	[副]
imci	[名]
imcixambi	[及]
imcin	[名]
imengge	[形]
imenggi	[名]
imenggilembi	[及]
imerhen	[名]
imete	[名]
imeten	[形]
imhe	[名]
imisun	[名]
imiyaha	[名]
imiyahanambi	[不及]
imiyalambi	[及]
imiyambi	[不及]
imiyan	[名]
imiyangga	[形]
imiyantu	[名]
imiyelembi	[及]
imiyesun	[名]
imrin	[名]
imseke	[名]
in	[名]
in jen	[名]
ina	[名]
incambi	[不及]
indahvlambi	[不及]
indahvn	[名]
indahvngga	[形]
indaju	[名]
indan	[名]
indebumbi	[及]
indehen	[名]
indembi	[不及]
indeme	[名]
inden	[名]
inderi	[名]
ine mene	[副]
ineku	[形]
inemene	[副]
inenggi	[名]
inenggishvn	[名]
ing	[名]
ing xi	[名]
ing lo	[名]
ingga	[形]
inggaha	[名]
inggali	[名]
inggari	[名]
ingguhe	[名]
ingtori	[名]
ingturi	[名]
iningge	[名]
iniyaha	[名]
injaha	[名]
injahan	[名]
injecembi	[不及]
injeku	[名]
injekuxembi	[及]
injembi	[不及]
injemeliyan	[形]
injendumbi	[不及]
injenumbi	[不及]
injesi	[名]
injiri	[名]
intu cecike	[形]
inu	[叹][名][小][副]
io ggang cing	[名]
iobin	[形]
iodan	[名]
ioi	[名]
ioi dzai	[名]
ioi hvwang	[名]
ioi ji	[名]
iolebumbi	[及]
iolembi	[及]
iose	[名]
iowan	[名]
iowanboo	[名]
iowanggiyaha	[名]
ira	[名]
irahi	[名]
irahinambi	[不及]
iren	[名]
irenembi	[不及]
ireshvn	[形]
irga	[名]
irgaxambi	[不及]
irge	[名]
irgebumbi	[及]
irgebun	[名]
irgece	[名]
irgen	[名]
irha	[名]
iri	[名]
irkimbi	[及]
irkinjimbi	[及]
irmu	[名]
irudai	[名]
irukv	[名]
irumbi	[不及]
irun	[名]
irungge	[形]
irushvn	[名]
irusu	[形]
isabumbi	[及]
isabun	[名]
isakv	[名]
isambi	[不及]
isamjambi	[及]
isan	[名]
isanambi	[不及]
isandumbi	[不及]
isangga	[形]
isanjimbi	[不及]
isanjingga	[形]
isanumbi	[不及]
ise	[名]
isebumbi	[及]
isebun	[名]
isecun	[名]
iseku	[名]
iselebumbi	[不及]
iseleku	[形]
iselembi	[及]
isembi	[不及]
isha	[名]
isheliyeken	[形]
isheliyen	[形]
ishu	[名]
ishulembi	[不及]
ishun	[形][后]
ishunde	[副]
isi	[名]
isihidabumbi	[不及]
isihidambi	[及]
isihimbi	[及]
isihiyambi	[及]
isimbi	[及]
isimeliyan	[形]
isinambi	[不及]
isinanggala	[副]
isingga	[形]
isinjimbi	[不及]
isirei	[副]
isitala	[后]
isohon	[名]
isu	[名]
isuhvn	[形]
isuka	[名]
isungge	[形]
isus	[名]
itele	[名]
iten	[名]
itu	[名]
itulhen	[名]
itung	[名]
iturhen	[名]
ituri	[名]
iuhu	[名]
ja	[形]
ja ja	[状]
ja ji	[状]
jaxu	[名]
jabxabumbi	[及]
jabxaki	[名]
jabxambi	[不及]
jabxan	[名]
jabacun	[名]
jabarhan	[名]
jabcacun	[名]
jabcambi	[不及]
jabcan	[名]
jabdubumbi	[及]
jabdugan	[名]
jabduhvn	[名]
jabduhvngga	[形]
jabduhangga	[形]
jabdumbi	[不及]
jabdunggala	[副]
jabhv	[名]
jabjan	[名]
jabkv	[名]
jabsun	[名]
jabtundumbi	[不及]
jabubumbi	[及]
jabumbi	[及]
jabun	[名]
jabunambi	[不及]
jabunggala	[副]
jabunubumbi	[及]
jaci	[副]
jacin	[名]
jacingge	[形]
jadagan	[名]
jadaha	[名]
jadahalambi	[不及]
jafaxambi	[及]
jafabumbi	[及]
jafahan	[名]
jafakv	[名]
jafakvngga	[形]
jafalan	[名]
jafan	[名]
jafanabumbi	[及]
jafangga	[名]
jafanjimbi	[及]
jafata	[名]
jafatambi	[及]
jafatarangge	[名]
jafu	[名]
jafukvngga	[形]
jafumumbi	[及]
jagasu	[名]
jaguri	[名]
jahvdai	[名]
jaha	[名]
jahacin	[名]
jahala	[名]
jahaltu	[形]
jahari	[名]
jai	[数][连][副]
jaici	[数]
jaida	[名]
jaidakv	[名]
jaidari	[名]
jaifan	[名]
jaifiyan	[名]
jailabumbi	[及]
jailambi	[不及]
jailanambi	[不及]
jailandumbi	[不及]
jailanumbi	[不及]
jailarambi	[不及]
jailatambi	[不及]
jain	[名]
jaira	[名]
jajambi	[及]
jajanambi	[不及]
jajanumbi	[不及]
jaji	[叹]
jajigi	[名]
jajilabumbi	[及]
jajilambi	[及]
jajin	[名]
jajuri	[名]
jajurinambi	[不及]
jak	[名]
jak jik	[状]
jakvci	[数]
jakvlkin	[名]
jakvmu	[名]
jakvn	[数]
jakvnggeri	[数]
jakvnju	[数]
jakvnjuci	[数]
jakvnjute	[数]
jakvri	[形]
jakvru	[名]
jakvta	[名][数]
jaka	[名][方][不及]
jakade	[连]
jakambi	[及]
jakan	[副]
jakanabumbi	[及]
jakanambi	[不及]
jakanjambi	[及]
jakarabumbi	[及]
jakarakv	[名]
jakarame	[后]
jakdan	[名]
jakdu	[数]
jakjahvn	[形]
jaksambi	[不及]
jaksan	[名]
jaksangga	[形]
jaksari	[形]
jaksun	[名]
jaktaha	[形]
jala	[名]
jalabumbi	[及]
jalafun	[名]
jalafungga	[形]
jalafuri	[名]
jalahi	[形]
jalakv	[名]
jalaktalambi	[不及]
jalaktambi	[不及]
jalaktan	[名]
jalambi	[不及]
jalan	[名]
jalandambi	[不及]
jalangga	[形]
jalari	[名]
jalasu	[名]
jalbalirambi	[不及]
jalbarimbi	[不及]
jaldambi	[及]
jalgambi	[及]
jalgan	[名]
jalgangga	[形]
jalgari	[形]
jalgasu	[名]
jalgiyabumbi	[及]
jalgiyambi	[及]
jalgiyanjabumbi	[及]
jalgiyanjambi	[及]
jalhambi	[及]
jalhan	[名]
jalhari	[形]
jalhiyanjambi	[及]
jali	[名]
jalidambi	[名]
jalimbi	[不及]
jalin	[后][连]
jalingga	[形]
jalmin	[名]
jalu	[形]
jalukiyabumbi	[及]
jalukiyambi	[不及]
jalumbumbi	[及]
jalun	[名]
jalundambi	[不及]
jalungga	[形]
jaluntu	[名]
jalupi	[形]
jalutala	[副]
jaman	[名]
jamarxambi	[不及]
jamarabumbi	[及]
jamarambi	[及]
jamaran	[名]
jamarandumbi	[不及]
jamaranumbi	[不及]
jambi	[不及]
jamdan	[名]
jampan	[名]
jampangga	[形]
jampin	[名]
jamu	[名]
jamuhari	[名]
jamuri	[名][数]
jan	[名]
janambi	[不及]
jancuhvn	[形]
jancuhvnje	[名]
jancuhvri	[名]
jang	[名]
jang giya keo	[名]
jang jing	[状]
jang loo	[名]
jangca	[名]
jangci	[名]
jangcin	[名]
jangdzy	[名]
janggvtai	[名]
janggvwan	[名]
jangga	[名]
janggalcambi	[不及]
janggalimbi	[不及]
jangge	[形]
janggin	[名]
janggiya	[名]
jangguci	[名]
jangju	[名]
jangkv	[名]
jangkiri	[名]
janglambi	[及]
jangturi	[名]
janjuri	[名]
jar	[状]
jargvci	[名]
jargima	[名]
jargisu	[名]
jargiyalakv	[名]
jarhv	[名]
jarhvn	[名]
jari	[名]
jarimbi	[不及]
jarin	[名]
jarji	[名]
jarkin	[名]
jasak	[名]
jasambi	[及]
jase	[名]
jaselambi	[及]
jaselumbun	[名]
jasibumbi	[及]
jasigan	[名]
jasihan	[名]
jasihiya	[名]
jasimbi	[及]
jasinambi	[及]
jasindumbi	[不及]
jata	[形]
jaya	[名]
jayabumbi	[及]
jayambi	[及]
jayan	[名]
je	[叹][名]
je ja	[状]
jebele	[名]
jebeletu	[名]
jebkexembi	[及]
jebkelebumbi	[及]
jebkelembi	[不及]
jebsehe	[名]
jecehen	[名]
jecen	[名]
jecuheri	[副]
jecuhunjembi	[不及]
jecuhuri	[副]
jedebule	[名]
jedzy	[名]
jefalan	[名]
jefohon	[名]
jegiyang	[名]
jeje	[名]
jekxun	[形]
jekde	[名]
jekdun	[形]
jekdungge	[形]
jekenembi	[及]
jekengge	[名]
jekenjimbi	[形]
jekse	[名]
jeksibumbi	[及]
jeksimbi	[及]
jeku	[名]
jekuju	[名]
jekunembi	[不及]
jelambi	[不及]
jelbe	[名]
jele	[名]
jeleme	[名]
jelen	[名]
jelgin	[名]
jelgiyen	[名]
jelken	[名]
jelmin	[名]
jelu	[名]
jembi	[及]
jemdelembi	[及]
jemden	[名]
jeme	[名]
jemengge	[名]
jemetu	[名]
jemgetu	[名]
jemin	[名]
jempilembi	[及]
jempin	[名]
jendembi	[不及]
jendu	[副]
jenduken	[形]
jendun	[名]
jeng	[副]
jengdun	[名]
jengge	[形]
jengke	[形]
jenumbi	[及]
jeo	[名]
jeofi	[名]
jeofingge	[形]
jerde	[名]
jerempe	[名]
jeren	[名]
jergi	[形][名][后]
jergicelembi	[及]
jergilebumbi	[及]
jergilembi	[不及]
jergilen	[名]
jergin	[名]
jergingge	[形][后]
jerguwelebumbi	[及]
jerguwelembi	[及]
jerguwen	[名]
jerin	[名]
jeringge	[形]
jerkixembi	[不及]
jerkin	[名]
jerpe	[名]
jerun	[名]
jeseri	[名]
jetembi	[及]
jeten	[名]
jeterengge	[名]
jeyen	[名]
jeyengge	[形]
ji ilha	[名]
ji nioi usiha	[名]
ji tiyan usin	[名]
jibca	[名]
jibcalambi	[不及]
jibcan	[名]
jibci	[名]
jibegun	[名]
jibehun	[名]
jibembi	[及]
jiberembi	[及]
jibge	[形]
jibin	[形]
jibsimbi	[及]
jibsinumbi	[不及]
jibsirge	[名]
jibumbi	[及]
jiduji	[副]
jidun	[名]
jidurambi	[及]
jifebumbi	[及]
jifembi	[及]
jifu nunggele	[名]
jifubumbi	[及]
jifun	[形]
jifunumbi	[不及]
jiganambi	[不及]
jigeyen	[名]
jiha	[名]
jihana	[形]
jihanambi	[不及]
jihari	[形]
jiji jaja	[状]
jijila	[状]
jijirgan	[名]
jijiri	[名]
jijubumbi	[及]
jijugan	[名]
jijuhan	[名]
jijumbi	[及]
jijun	[名]
jijungga	[形]
jijungge	[形]
jikv	[名]
jilacuka	[形]
jilacungga	[形]
jilakan	[形]
jilambi	[及][不及]
jilan	[名]
jilan muke	[名]
jilangga	[形]
jilari	[形]
jilbimbi	[及]
jilbin	[名]
jilehun	[形]
jilerxembi	[不及]
jilerjembi	[不及]
jilga	[名]
jilgambi	[不及]
jilgan	[名]
jilgandumbi	[不及]
jilgangga	[形]
jilgibumbi	[及]
jilgilambi	[及]
jilgimbi	[及]
jilha	[名]
jilhambi	[及]
jilhangga	[形]
jili	[名]
jilidambi	[不及]
jilihangga	[形]
jilingga	[形]
jilkilambi	[及]
jilkimbi	[形]
jilkin	[名]
jilun	[形]
jima	[名]
jimalambi	[及]
jimbi	[不及]
jin xi	[名]
jing	[名][副]
jing jiyang	[状]
jinggeri	[名]
jinggiya	[名]
jingjan	[形]
jingjanambi	[不及]
jingjara	[名]
jingji	[名]
jingjing jangjang	[状]
jingkini	[形]
jingnembi	[不及]
jingse	[名]
jingsitun	[名]
jinjaha	[名]
jinjiba	[名]
jinjima	[名]
jinjiri janjari	[状]
jir	[状]
jira	[名]
jiramikan	[形]
jiramilabumbi	[及]
jiramilambi	[及]
jiramilanjimbi	[及]
jiramin	[形]
jiramirambi	[及]
jiren	[名]
jirgabumbi	[及]
jirgacun	[名]
jirgambi	[不及]
jirgeku	[名]
jirgembi	[不及]
jirgembumbi	[及]
jirgio	[名]
jirha	[形]
jiri	[数]
jirjing	[名]
jirumtu	[形]
jirun	[数]
jisa	[名]
jise	[名]
jiselembi	[不及]
jisiha	[名]
jisubumbi	[及]
jisumbi	[及]
jiya	[叹]
jiyan	[名]
jiyan Rung	[名]
jiyan wang asu	[名]
jiyang	[名]
jiyanggiyvn	[名]
jiye	[叹]
jiyei	[名]
jo	[叹][名]
jo banjimbi	[不及]
joboxombi	[不及]
jobobumbi	[及]
jobocuka	[形]
jobocun	[名]
jobolon	[名]
jobolontu	[形]
jobombi	[不及]
jobon	[名]
joboshvn	[名]
jobu	[名]
jocibumbi	[及]
jocimbi	[不及]
jocin	[名]
jodoba	[名]
jodobumbi	[及]
jodohvn	[名]
jodombi	[及]
jodon	[名]
jodongga	[形]
jodorgan	[名]
jodorho	[名]
jofoho	[名]
jofohoci	[名]
jofoholobumbi	[及]
jofohon	[名]
jofohongge	[形]
jofohonggo	[形]
jofohori	[形]
jofohoto	[名]
johibumbi	[不及]
johimbi	[不及]
joholimbi	[不及]
johombi	[不及]
jojin	[名]
jok	[状]
jokv	[名]
jokjambi	[及]
joksi	[名]
joksikv	[名]
joksilambi	[及]
joksinambi	[不及]
jokson	[名]
joktonda	[名]
jolabumbi	[及]
jolacambi	[不及]
jolbonombi	[不及]
joldombi	[及]
jolgocombi	[不及]
jolhocombi	[不及]
jolhombi	[不及]
joli	[名]
jolibumbi	[及]
joligan	[名]
jolikv	[名]
jolimbi	[及]
jolinambi	[及]
jolinjimbi	[及]
jolo	[名]
joman	[名]
jombi	[及]
jombumbi	[及]
jon	[名]
jondobumbi	[及]
jondombi	[及]
jondon	[名]
jong jong	[状]
jongdon	[名]
jonggin	[名]
jongginambi	[及]
joni	[名]
jonombi	[及]
joo	[叹][名]
joo modo	[名]
joocin	[名]
joogiya	[名]
joojin	[名]
joolabumbi	[及]
joolambi	[及]
joolibumbi	[及]
jooligan	[名]
joolikv	[名]
joolimbi	[及]
joolinambi	[及]
joolinjimbi	[及]
jooman	[名]
joombi joo	[及]
jor	[状]
joran	[形]
jordabumbi	[及]
jordambi	[不及]
jorgimbi	[不及]
jorgindumbi	[不及]
jorgirhen	[名]
jorgocen	[名]
jorgon	[名]
jorho	[名]
jorixambi	[及]
jorixembi	[及]
joribumbi	[及]
jorihv	[名]
jorikto	[形]
jorilambi	[及]
jorimbi	[及]
jorin	[名]
joringga	[名]
jorisi	[名]
jorkimbi	[不及]
joro	[名]
joron	[名]
jortai	[副]
jortaingge	[形]
jortanggi	[副]
jotombi	[不及]
ju	[名]
ju sy	[名]
juxa	[名]
juxembi	[不及]
juxembumbi	[及]
juxempe	[名]
juxen	[名]
juxeri	[名]
juxuci	[名]
juxucihe	[名]
juxuhuken	[形]
juxuhun	[形]
juxuhuri	[名]
juxuk	[名]
juxun	[名]
juxuri	[名]
juxuru	[名]
juxutu	[名]
juxutun	[名]
jubexebumbi	[不及]
jubexembi	[及]
juben	[名]
jubesi	[名]
jubki	[名]
jubu	[名]
jubungga	[名]
juburxembi	[不及]
juce	[名]
jucelebumbi	[及]
jucelembi	[不及]
jucerhen	[名]
juciba	[名]
juculembi	[不及]
juculesi	[名]
jucuma	[名]
jucun	[名]
jucungge	[形]
juda	[名]
judun	[名]
judura	[名]
judurakv	[名]
judurambi	[不及]
juduran	[名]
jufeliyebumbi	[不及]
jufeliyembi	[及]
jufeliyen	[名]
jugvn	[名]
jugembi	[不及]
juhe	[名]
juhen	[形]
juhenembi	[不及]
juhimbi	[不及]
juhiyan	[名]
jui	[名]
jujin	[名]
juju jaja	[状]
jujumbi	[及]
jujurambi	[不及]
jujurembi	[不及]
jujuri majari	[状]
jukden	[名]
juke	[名]
juken	[副]
jukesi	[副]
juki	[形]
jukibumbi	[及]
jukidun	[名]
jukimbi	[及]
jukjambi	[及]
jukjuhu	[名]
jukte	[名]
juktehen	[名]
juktelebumbi	[及]
juktelembi	[及]
juktembi	[及]
jukten	[名]
juktesi	[名]
juktu	[名]
jukturi	[名]
julan	[名]
julangga	[形]
julebumbi	[及]
julefun	[后]
julen	[名]
julergi	[方]
julergingge	[形]
juleri	[方]
julesi	[方]
julesiken	[方]
juletun	[名]
julgv	[名]
julge	[名]
julgen	[名]
julgume	[名]
julhv	[名]
julhvmbi	[及]
julhun	[名]
julibumbi	[及]
julimbi	[不及]
julishvn	[形]
juliyambi	[及]
julkun	[名]
julungga	[名]
jumalambi	[及]
juman	[名]
jumangga	[形]
jumanggi	[名]
jumanggilambi	[及]
jumara	[名]
jumargan	[名]
jumbali	[不及][副]
jun	[名]
jun gung	[名]
junara	[名]
jung	[名]
jung dzo xo	[名]
jung ging	[名]
jung giyvn	[名]
jung jeng diyan	[名]
jung ni	[名]
jung yuwan	[名]
jungxu	[名]
jungxun	[名]
junggala	[名]
jungge	[形]
junggebumbi	[及]
junggembi	[及]
junggeri	[形]
junggidei	[形]
junggila	[形]
junggin	[名]
jungginambi	[及]
junggingge	[形]
junggiri	[形]
junggisun	[名]
junggitu	[名]
junggiyang	[名]
jungguhe	[名]
jungken	[名]
jungkengge	[名]
junihin	[名]
juningge	[名]
junisu	[名]
junta	[名]
jurambi	[不及]
jurambumbi	[及]
juran	[名]
jurandambi	[不及]
juranumbi	[不及]
jurcebumbi	[及]
jurcehen	[名]
jurcejembi	[及]
jurcembi	[及]
jurgalambi	[及]
jurgan	[名]
jurgangga	[形]
jurgantu	[名]
jurgatu	[形]
jurgimbi	[及]
jurguntu	[形]
jurha	[名]
jurhu	[名]
jurhuju	[名]
jurhun	[名]
jurjun	[名]
jurkixembi	[不及]
jursan	[形]
jursi	[名]
jursu	[名]
jursulebumbi	[及]
jursulembi	[及]
jurturu	[名]
juru	[名]
jurucilen	[名]
juruju	[名]
juruken	[形]
jurulebumbi	[及]
jurulembi	[及]
jurumbi	[及]
jurun	[名]
jurungge	[形]
jurutu	[名]
juseki	[形]
jusetu	[形]
jushe	[名]
jusibumbi	[及]
jusimbi	[及]
justalabumbi	[及]
justalambi	[及]
justan	[名]
justangga	[形]
jusubumbi	[及]
jusukv	[名]
jusumbi	[及]
jutungga	[形]
jutunhan	[名]
juturi	[名]
juwabumbi	[及]
juwajiri	[名]
juwakjabumbi	[及]
juwali	[名]
juwambi	[及]
juwan	[数]
juwanci	[数]
juwanda	[名]
juwang duwan	[名]
juwang yuwan	[名]
juwangduwan	[名]
juwangga	[形]
juwanggeri	[数]
juwanta	[数]
juwaran	[形]
juwaratambi	[不及]
juwari	[名]
juwarikten	[名]
juwaringga	[形]
juwata	[数]
juwatanggeri	[数]
juwe	[数]
juwebumbi	[及]
juweci	[数]
juwedembi	[不及]
juwembi	[及]
juwen	[名]
juwenggeri	[数]
juwenumbi	[及]
juwenusi	[名]
juwerge	[名]
juwete	[数]
juyedun	[名]
juyehen	[名]
juyembi	[及]
juyen	[名]
jy	[名]
jy hiyan	[名]
jy jeo	[名]
jy nioi usiha	[名]
jyfu	[名]
jyhiyan	[名]
jyli	[名]
jytu	[名]
Kamduri	[名]
Kang	[名]
Kengselembi	[及]
Ko	[名]
kv ca	[状]
kvbulibumbi	[及]
kvbulin	[名]
kvburi	[名]
kvca	[名]
kvdargalambi	[及]
kvdargan	[名]
kvdarhan	[名]
kvke	[形]
kvlan	[形]
kvlibumbi	[不及]
kvlimbi	[不及]
kvlin calin	[形]
kvlincambi	[不及]
kvlisidambi	[不及]
kvlisitambi	[不及]
kvngga	[名]
kvr kar	[状]
kvrcalambi	[不及]
kvrcan	[名]
kvrclanambi	[不及]
kvrdambi	[及]
kvru	[名]
kvtan	[名]
kvthvmbi	[及]
kvthvri	[名]
kvtka	[名]
kvtu fata	[状]
kvtuktu	[名]
kvwa	[形]
kvwaca	[名]
kvwacambi	[不及]
kvwacarabumbi	[及]
kvwacarambi	[及][不及]
kvwafihiyambi	[不及]
kvwaha	[名]
kvwahalambi	[及]
kvwai fai	[状]
kvwak cak	[状]
kvwala	[形]
kvwalabumbi	[及]
kvwalaci	[名]
kvwalambi	[及]
kvwalar	[状]
kvwang	[状]
kvwangtahvn	[形]
kvwar	[状]
kvwarambi	[及]
kvwaran	[名]
kvwas	[状]
kvwasa	[形]
kvwatar	[状]
kvwatiki	[名]
kvwatir	[名]
kvweici	[名]
kvweicidambi	[不及]
kvyala	[名]
kab	[状]
kabxambi	[不及]
kaba	[形]
kabangga	[形]
kabari	[形][名]
kabcihvn	[形]
kabsidarabi	[不及]
kabsitambi	[不及]
kabumbi	[及]
kacang	[状]
kacar	[状]
kaciki	[名]
kacilan	[名]
kadalaci	[名]
kadalakv	[名]
kadalambi	[及]
kadalan	[名]
kadalangga	[名]
kadalatu	[名]
kadarakv	[形]
kadurxambi	[不及]
kadurambi	[不及]
kafur	[状]
kaharakca	[名]
kai	[小]
kaica	[名]
kaicabumbi	[及]
kaican	[名]
kaici	[名]
kaiciri	[名]
kaidu	[形]
kaikada	[形]
kaikadalambi	[不及]
kaikamari	[名]
kaikarambi	[不及]
kaikari	[名]
kailan	[名]
kailari	[名]
kailun	[形]
kaipi	[名]
kaitu	[形]
kajambi	[及]
kakv	[名]
kakvng	[状]
kakvr	[状]
kaka	[名][状]
kakabumbi	[及]
kakafi	[状]
kakambi	[不及]
kakarashvn	[形]
kaki	[形]
kakiri	[名]
kakitu	[名]
kaksaha	[名]
kaksimbi	[及]
kalaxvn	[形]
kalaxambi	[不及]
kalang	[状]
kalar	[状]
kalbi	[名]
kalbikv	[名]
kalbimbi	[及][名]
kalbiyambi	[及]
kalcahvn	[形]
kalcuhvn	[形]
kalcun	[名]
kalcunggi	[形]
kalfimbi	[及]
kalfin	[名]
kalfini	[名]
kalfinju	[名]
kalfintu	[名]
kalfiyambi	[不及]
kalfiyan	[形]
kalimbi	[不及]
kalimu	[名]
kalinambi	[不及]
kalja	[形]
kaljakv	[形]
kaljangga	[形]
kalju	[名]
kalka	[名]
kalkan	[名]
kalkangga	[形]
kaltarxarabi	[不及]
kaltara	[形]
kaltarambi	[不及]
kaltu mulu	[形]
kalu mulu	[形]
kalumimbi	[及]
kambi	[及]
kambil	[及]
kambuljambi	[不及]
kamcibumbi	[不及]
kamcigan	[名]
kamcimbi	[及]
kamcin	[名]
kamkv	[名]
kamni	[名]
kamnibumbi	[及]
kamtu	[名]
kamtun	[名]
kanagan	[名]
kanda	[名]
kandahan	[名]
kandarhan	[名]
kandatu	[名]
kang	[状]
kanggv	[形]
kanggvr	[状]
kanggaxadambi	[及]
kanggaxambi	[及]
kanggarxambi	[不及]
kanggasikv	[名]
kanggasitambi	[及]
kanggili	[形]
kanggir	[状]
kanggiri	[名]
kangkambi	[不及]
kangnambi	[及]
kangsambi	[及]
kangsanggi	[形]
kangsari	[名]
kangsiri	[名]
kangtarxambi	[不及]
kani	[名]
kanin	[名]
kaningga	[形]
kanjambi	[及]
kanjidu	[名]
kanjiha	[形][及]
kaowata kiti	[状]
kapahvn	[形]
kaparambi	[及]
kapi	[名]
kar	[状]
kara	[形][名]
karaba	[形]
karabumbi	[及]
karahan	[名]
karahi	[形]
karaki	[名]
karalja	[名]
karaltu	[名]
karambi	[及]
karan	[名]
karanambi	[及]
karandumbi	[及]
karangga	[形]
karanidun	[名]
karanjimbi	[及]
karanumbi	[及]
karasu	[名]
karcabumbi	[不及]
karcambi	[及]
karcandumbi	[不及]
karcanumbi	[不及]
karcin	[名]
kargama	[名]
kargibumbi	[及]
kargimbi	[及]
karhama	[名]
karimbi	[不及]
karka	[形]
karkakv	[名]
karkalan	[名]
karkambi	[及]
karkandumbi	[不及]
karmabumbi	[及]
karmacun	[名]
karmakv	[名]
karmambi	[及]
karman	[名]
karmangga	[名]
karmani	[名]
karmanumbi	[及]
karmarambi	[及]
karmasi	[名]
karmatambi	[及]
karmatangga	[形]
karmatu	[形]
kartukv	[名]
karu	[名]
karuxarabi	[不及]
karulabumbi	[及]
karulambi	[不及]
karulan	[名]
karun	[名]
kas	[状]
kasari	[形]
kaskan	[名]
kaskanambi	[不及]
kata	[状]
katabumbi	[及]
katak	[状]
katambi	[不及]
katang	[状]
katangga	[形]
katar	[状]
katarabmnbi	[及]
katarambi	[不及]
katun	[形][名]
katungga	[形]
katunjambi	[不及]
katur	[状]
katuri	[名]
ke	[叹][名]
keb	[状]
kebse	[副]
kebsimbi	[及]
kebsisu	[名]
kecer	[状]
keci maci	[状]
kecu	[形]
kecun	[形]
kederxembi	[及]
kederexembi	[及]
kederebumbi	[及]
kederelembi	[及]
kederembi	[及]
keehudembi	[不及]
keibiri	[形]
keibisu	[名]
keifu	[名]
keifulembi	[及]
keike	[形]
keikedembi	[不及]
keikeljembi	[不及]
keikembi	[不及]
keikuhen	[名]
keilen	[名]
keire	[形]
kejine	[形]
kejini	[形]
kek	[状]
keke	[名][状]
kekeri	[名]
keksebuku	[名]
keksebumbi	[及]
keksembi	[及]
keksen	[名]
keksengge	[形]
kekte	[形]
kektehun	[名]
keku	[形][名]
kekuhe	[名]
kekutu	[名]
keleng kalang	[状]
keler kalar	[状]
kelfixembi	[不及]
kelfimbi	[不及]
keli	[名]
keltehe	[名]
kelterhen	[名]
kemxu	[名]
kemin	[名]
kemki kamki	[状]
kemkixembi	[不及]
kemkimbi	[及]
kemnebumbi	[及]
kemneku	[名]
kemnembi	[及]
kemnen	[名]
kemu	[名]
kemuhen	[名]
kemun	[名]
kemungge	[形]
kemuni	[副]
kemuri	[形]
kendele	[形]
kenderhen	[名]
kenehunjecuke	[形]
kenehunjembi	[及]
kenehunjen	[名]
kenekun	[名]
keng	[状]
kengcembi	[不及]
kenggehun	[形]
kenggeri	[名]
kenggin	[名]
kengkexembi	[不及]
kengkembi	[不及]
kengse	[副]
kengsejembi	[不及]
kengselebumbi	[及]
kengsixembi	[不及]
kengsimbi	[不及]
kengtehun	[形]
kenje	[形]
ker	[状]
kercibumbi	[及]
kercimbi	[及]
kerecin	[名]
keremu	[名]
kerkenembi	[不及]
kerkeri	[名]
kerkimbi	[不及]
kerme	[名]
kermeyen	[形]
kersen	[名]
kersu	[名]
keru	[名]
kerulembi	[及]
kerun	[名]
kes	[状]
kese masa	[形]
kesembi	[不及]
keser	[状]
kesi	[名]
kesike	[名]
kesiken	[名]
kesingge	[形]
kesiri masiri	[形]
kete kata	[名][状]
ketek	[状]
keyen	[名]
kflang kalang	[状]
kfltangga	[形]
khnun	[名]
ki	[名]
ki dan	[名]
ki kv	[状]
ki yang jodon	[名]
kixan	[形]
kiximixi	[名]
kib	[状]
kicebe	[形]
kicebmnbi	[及]
kiceln bi	[及]
kicen	[名]
kicendumbi	[及]
kicenumbi	[及]
kidumbi	[及]
kidun	[形]
kifur	[状]
kijimi	[名]
kikvr	[状]
kiki kaka	[状]
kila	[名]
kilahvn	[名]
kilakci	[名]
kilambi	[及]
kilhana	[名]
kilin	[名]
kiltan	[名]
kiltari	[名]
kiluk	[名]
kima	[名]
kimcibumbi	[及]
kimcikv	[形]
kimcimbi	[及]
kimcin	[名]
kimcinumbi	[及]
kimcisi	[名]
kimcndumbi	[及]
kimhan	[名]
kimulambi	[不及]
kimulebumbi	[及]
kimulembi	[不及]
kimundumbi	[不及]
kimuntumbi	[不及]
kin	[名]
kin tiyan giyan	[名]
kina	[名]
kinamu	[名]
king	[名][状]
kinggiri	[名]
kinggki	[状]
kingguhe	[名]
kingken	[名]
kingkiri	[状]
kinmngge	[形]
kintala	[及]
kinunlbi	[及]
kioi	[名]
kiongguhe	[名]
kionggun	[名]
kiongguri	[名]
kior	[状]
kiraga	[形]
kirfu	[名]
kirho	[名]
kiriba	[形]
kiribumbi	[及]
kirikv	[名]
kirinjambi	[不及]
kirsa	[名]
kiru	[名]
kiruda	[名]
kirumbi	[名]
kirusi	[名]
kisari	[名]
kitala	[名]
kitari	[名]
kitir	[状]
kituhangga	[形]
kiya	[名]
kiyab	[状]
kiyadambi	[及]
kiyafur kifur	[状]
kiyak	[状]
kiyakv	[名]
kiyakvha	[名]
kiyakvng	[状]
kiyalabmnbi	[及]
kiyalambi	[及]
kiyalang	[状]
kiyalmabumbi	[及]
kiyalmagan	[名]
kiyalmambi	[及]
kiyambi	[及]
kiyamkambi	[及]
kiyamnambi	[及]
kiyamnan	[形]
kiyan	[名]
kiyan cing men	[名]
kiyangdu	[形]
kiyangdukan	[形]
kiyangdulambi	[及]
kiyangkiyaxambi	[不及]
kiyangkiyan	[形]
kiyangkiyatu	[名]
kiyangsimbi	[不及]
kiyar	[状]
kiyaribumbi	[及]
kiyarimbi	[及][不及]
kiyarkiya	[状]
kiyas	[状]
kiyata	[名]
kiyatar	[状]
kiyatubumbi	[及]
kiyatumbi	[及]
kiyatur kitur	[状]
kiyen	[名]
kiyokan	[名]
kiyokiyon	[名]
kiyolorjombi	[不及]
kiyoo	[名]
kiyooha	[名]
kmngetu	[名]
kmnungge	[形]
knmehurelnbi	[不及]
knndulembi	[及]
knskun	[状]
ko	[名]
ko ka	[状]
kob	[状]
kobcihiyadambi	[及]
kobcihiyan	[形]
kobcimbi	[不及]
kobdolombi	[不及]
kobdon	[名]
kobi	[名]
kobkolombi	[及]
kobsohon	[形]
kobsoljombi	[不及]
kobto	[形]
kobtolombi	[及]
kobton	[名]
kobtonggo	[形]
koco	[名]
kodo	[名]
kofen	[形]
kofor	[名][状]
kofori	[名]
koforinambi	[不及]
kohnafi	[形]
kohodombi	[不及]
kohong kohong	[状]
koibumbi	[及]
koika	[名]
koikalambi	[及]
koikohon	[形]
koikoljombi	[不及]
koikon	[名]
koimalidambi	[不及]
koiman	[形]
koimari	[形]
koimasidambi	[不及]
koimasitambi	[不及]
koiton	[形]
koitonggo	[形]
kojohombi	[及]
koki	[名]
kokima	[形]
kokingga	[形]
kokirakv	[形]
kokiran	[名]
kokirandumbi	[不及]
kokirangga	[形]
kokirarakv	[不及]
kokndumbi	[及]
koko	[状]
kokodombi	[不及]
kokoli	[名]
kokolimbi	[及]
koksimbi	[不及]
koksin	[形]
kolabumbi	[及]
kolambi	[及]
kolon	[形]
kolongso	[名]
kolor	[状]
komo	[名]
komolobmnbi	[及]
komolombi	[及]
komon	[名]
komso	[形]
komsokon	[形]
komsolabumbi	[及]
komsolambi	[及]
komsolombi	[及]
komsongge	[名]
konggir	[状]
konggohon	[形]
konggolo	[名]
konggor	[状]
konggoro	[形]
konggur	[状]
kongsimbi	[不及]
konjisun	[名]
konjosu	[名]
koofingga	[形]
koojiha	[名]
koolambi	[及]
kooli	[名]
koosa	[形]
kor	[状]
korcin	[名]
kordon	[名]
kordonggo	[名]
korimbi	[及]
korkong korkong	[状]
koro	[名]
korsocun	[名]
korsombi	[不及]
korsondumbi	[不及]
korsonumbi	[不及]
kos	[状]
kosha	[名]
kosihimbi	[及]
koskon kaskan	[副]
kotofi	[名]
kotong	[状]
kotor	[状]
koyorholombi	[及]
ku	[名]
kuKan	[名]
kuxun	[形]
kuxungge	[形]
kub	[状]
kubcen	[名]
kubcin	[名]
kuberhen	[名]
kuberhenembi	[不及]
kubmnbi	[及]
kubsuhun	[形]
kubsuhuri	[形]
kubsurembi	[不及]
kubuhen	[名]
kubun	[名]
kubunemb	[不及]
kubungge	[形]
kuburhen	[名]
kuciker	[形]
kude	[形]
kudexembi	[及]
kudebumb	[及]
kudembi	[及]
kuerca	[形]
kufan	[名]
kufang	[名]
kufur	[状]
kufuyen	[形]
kugguhen	[形]
kuhen	[名]
kuhengge	[名]
kui hvwa ilha	[名]
kuii	[名]
kuilebumbi	[及]
kuileku	[名]
kuilembi	[及]
kuinihe	[名]
kuk	[状]
kukdu	[名]
kukduri	[形]
kukekun	[形]
kukele	[形]
kuken	[名]
kukji	[名]
kuklembi	[及]
kukmembi	[不及]
kuku	[形]
kukuri	[名]
kulge	[名]
kulkun	[名]
kulkuri	[形]
kulu	[形]
kuluk	[名]
kulun	[名]
kuluri	[形]
kulutu	[名]
kumbi	[不及]
kumcuhun	[形]
kumcun	[形]
kumdu	[形]
kumdulebumbi	[及]
kumdulembi	[不及]
kumdun	[形]
kumuci	[名]
kumuda	[名]
kumun	[名]
kumusi	[名]
kundu	[形]
kundujin	[名]
kundulecuke	[形]
kundulen	[形]
kundulendumbi	[及]
kundulenumbi	[及]
kundun	[形]
kunesun	[名]
kung	[状]
kungxuken	[形]
kungxun	[形]
kungdzy	[名]
kungeri	[状]
kungfudzy	[名]
kungge	[名]
kunggeri	[名]
kunggu	[名]
kungguhun	[形]
kunggur	[状]
kunmi	[名]
kunusun	[名]
kur	[状]
kurbu	[名]
kurbuxembi	[不及]
kurbuxetembi	[不及]
kurbumbi	[不及]
kurbutembi	[不及]
kurce	[名]
kurcilembi	[及]
kurcin	[名]
kurdun	[名]
kure	[名]
kurehu	[名]
kurelembi	[及]
kuren	[形][名]
kurene	[名]
kuri	[形]
kurima	[名]
kuringge	[形]
kurisi	[名]
kurken	[形]
kurku	[名]
kurne	[名]
kuro	[形]
kuru	[形]
kurume	[名]
kurune	[名]
kus	[状]
kuskurembi	[不及]
kuteci	[名]
kutitu	[形]
kutule	[名]
kutulebumbi	[及]
kutulembi	[及]
kutung	[状]
kutur	[状]
kuturxembi	[不及]
kuturcembi	[不及]
kuwalar	[状]
kuwangse	[名]
kuweciheri	[形]
kuweehihe	[名]
kuwelembi	[及]
kuye fiyaha	[名]
kuyerhen	[名]
la li	[状]
laxa	[名]
lab	[状]
laba	[名]
labarhvn	[形]
labari	[名]
labdahvn	[形]
labdarambi	[不及]
labdu	[形]
labdukan	[形]
labdulambi	[及]
labi	[名]
labsa	[副]
labsafi	[名]
labsambi	[不及]
labsan	[名]
labsimbi	[及][不及]
labsitambi	[不及]
labta	[形]
lacadambi	[不及]
ladu	[名]
ladurambi	[及]
lafihiyan	[形]
lafu	[形]
lagu	[名]
lahvta	[名]
laha	[名]
lahari	[名]
lahin	[形]
lai coko	[名]
laidakv	[形][名]
laidambi	[及]
laifa	[名]
laifarambi	[不及]
laihv	[名]
laihvxambi	[不及]
laihvn	[名]
laihvtu	[名]
laju	[形]
lajukan	[形]
lak	[状]
lakacan	[名]
lakca	[名]
lakcambi	[不及]
lakdahvn	[形]
lakdahvri	[形]
lakdari	[副]
lakiyakv	[名]
lakiyan	[名]
lakiyandzimbi	[及]
lakiyangga	[形]
lakiyari	[形]
laku	[名]
lala	[形][名]
lalabumbi	[不及]
lalahvn	[形]
lalaji	[副]
lalambi	[不及]
lalanju	[副]
lalarlhi	[副]
lali	[形][名]
lalln	[形]
laluri	[名]
lama	[名]
lampa	[形]
lampangga	[形]
lampari	[名]
lamu	[名]
lamudai	[名]
lamukan	[形]
lamuke	[名]
lamun	[形]
lamurhan	[名]
lan	[名]
lang giyvn	[名]
lang lang	[状]
langgv	[名]
langgambi	[不及]
langjeo	[名]
langju	[名]
langka	[名]
langlai	[名]
langmngga	[形]
langse	[形][名]
langsedambi	[及]
langtanambi	[不及]
langtangga	[形]
langtu	[名]
langtulambi	[不及]
lanu	[名]
lar	[状]
larbahvn	[形]
largixambi	[不及]
largin	[形]
larhvn	[名]
larin	[名]
larsen	[形]
larsenda	[名]
larturi	[名]
lasadnambi	[不及]
lasan	[名]
lasari	[形]
lasha	[副]
lashajambi	[不及]
lashalabi	[及]
lashalambi	[及]
lashalan	[名]
lashangga	[形]
lasihikmbi	[名]
lasihimbi	[及]
lasumbi	[不及]
lata	[形]
latai	[名]
latakan	[形]
latihi	[名]
latiki	[名]
latubukv	[名]
latukv	[名]
latumbi	[不及]
latumeliyan	[副]
latunambi	[不及]
latungga	[形]
latungjimbi	[不及]
laturengge	[名]
layabumbi	[及]
layambi -ka	[不及]
le	[小]
leb	[状]
lebdehun	[形]
lebderembi	[不及]
lebenggi	[形]
lebkidemdi	[不及]
leder	[状]
lefu	[名]
lefungge	[形]
lehebumbi	[及]
lehele	[形]
lehembi	[不及]
lehendumbi	[不及]
lehenumbi	[不及]
lehime	[名]
lejirhi	[名]
lekcehun	[形]
lekde lakda	[状]
lekdehun	[形]
lekderembi	[不及]
lekderi	[形]
leke	[名]
lekebumbi	[及]
lekedembi	[不及]
lekegi	[名]
lekembi	[及]
lekerhi	[名]
lekeri	[名]
lekerihe	[名]
lekerihin	[名]
lekiderabi	[不及]
leksei	[副]
lekseki	[形]
lela	[状]
leli	[形][名]
lempe	[名]
lempen	[名]
lempi	[名]
lempinembi	[不及]
len	[形]
lenggeri	[名]
lenggetu	[名]
lengken	[形]
lenglen langlan	[状]
lengseki	[形]
lengsenggi	[形]
lengtenembi	[不及]
leo di	[名]
leolebumbi	[及]
leolecembi	[及]
leolembi	[及]
leolen	[名]
leolenumbi	[及]
leombi	[不及]
leose	[名]
lergin	[形]
lergiyen	[形]
lesumbi	[不及]
let	[状]
lete lata	[状]
letehun	[形]
letuhun	[形]
leycun	[名]
leyembi	[及]
li	[名]
lib	[状]
libki	[形]
libu	[名]
licise	[名]
lidu	[名]
lifa	[名][副]
lifada	[名]
lifadambi	[不及]
lifagan	[名]
lifahan	[名]
lifahanambi	[不及]
lifakv	[名]
lifambi	[不及]
lifan	[名]
ligiya	[名]
limati	[名]
limu	[名]
lin cing ja	[名]
ling	[状]
ling cing	[名]
lingdan	[名]
lingge	[名]
lingguefifi	[名]
lingjy	[名]
lingse	[名]
lingsika	[名]
lio sing	[名]
liohvwang	[名]
lioho	[名]
liokio	[名]
lirha	[名]
lirlng	[名]
lit liyar	[状]
liyan peng	[名]
liyang jeo	[名]
liyar	[状]
liyefiyebumbi	[及]
liyefiyenumbi	[不及]
liyeliyexembi	[不及]
liyeliyehun	[形]
liyeliyembi	[不及]
liyeliyen	[形]
liyeliyendumbi	[不及]
liyoliyo	[叹]
liyooha	[名]
liyor	[状]
liyu li	[名]
lmohombi	[不及]
lnuren	[名]
lo	[形][名]
lo bing	[名]
lo han	[名]
lo la	[状]
lobi	[形]
lobitu	[名]
loca	[名]
lodan	[名]
loft	[形]
lohv	[名]
loho	[名]
lohobumbi	[不及]
lok	[状]
lokdi	[形]
lokdo lokda	[状]
lokdohon	[副]
lokdori	[副]
loksimbi	[不及]
loksinambi	[不及]
loksobubumbi	[及]
loksobumbi	[不及]
lolo	[名][状]
lomi	[名]
lomikte	[名]
long	[状]
longko	[名]
longkon	[名]
longsikv	[名]
longsimbi	[及]
longto	[名]
longtolobumbi	[及]
longtolombi	[及]
loo	[名]
loombi	[不及]
lor	[状]
lorbodo	[名]
lorin	[名]
losa	[名]
loshan	[名]
loso	[形]
lostu	[形]
lotion	[名]
lu	[名]
lu xui	[名]
luxi	[名]
ludahvn	[名]
ludur	[状]
lugiya	[名]
luhexembi	[及]
luhu	[名]
luhulebumbi	[及]
luhulembi	[及]
lujen	[名]
luju	[名]
lujuri	[名]
luk	[状]
luka	[名]
lukdu	[状]
lukduhun	[形]
lukdurernbi	[不及]
luke	[名]
luksimbi	[不及]
luku	[形][名]
lukuken	[形]
lula	[状]
lulu	[状]
lumbabumbi	[及]
lumbambi	[及]
lumbanambi	[不及]
lumbur	[状]
lumburjambi	[不及]
lung	[名]
lunggu	[名]
lur	[状]
lurgixembi	[不及]
lurgiken	[形]
lurgin	[形]
luse	[名]
lushun	[形]
lusnmbi	[不及]
lusu	[形]
lutabu	[形]
luwan	[名]
luwanggun	[名]
ma	[叹]
maxa	[名]
maxalakv	[名]
maxan	[名]
maxangga	[形]
mabu	[名]
mabulabumbi	[及]
mabulakv	[名]
mabulambi	[及]
maca	[名]
maci	[名]
macibumbi	[及]
maciha	[名]
macihi	[名]
macika	[名]
macimbi	[及]
macumbi	[不及]
madabuhangge	[名]
madabumbi	[及]
madagan	[名]
madage	[名]
madambi	[不及]
madangga	[形]
madari	[名]
madasu	[名]
mafa	[名]
mafuta	[名]
mager	[名]
magiya	[名]
mahv	[名]
mahvlabumbi	[不及]
mahvlambi	[及]
mahvntu	[名]
mahaggala	[名]
mahala	[名]
mahalalambi	[及]
mahatu	[名]
mahatun	[名]
maigu	[名]
maihvngga	[形]
maijuha	[名]
maikan	[名]
mailambi	[不及]
mailaru	[名]
mailasun	[名]
maimaxambi	[及]
maimadambi	[不及]
maise	[名]
maishan	[名]
maisiri	[名]
maitakv	[名]
maitu	[名]
maituxambi	[及]
maitulmbi	[名]
maitun	[名]
majan	[名]
majige	[形]
maka	[副]
makambi	[不及]
makarambi	[不及]
maki	[名]
makitu	[名]
makjan	[形]
makjanambi	[不及]
maksibumbi	[及]
maksikv	[名]
maksimbi	[不及]
maksin	[名]
maksinambi	[不及]
maksinjimbi	[不及]
maksirengge	[名]
maksisi	[名]
maktaxambi	[及]
maktambi	[及]
maktandumbi	[不及]
maktanumbi	[及]
mala	[名]
malaxarabi	[及]
malahi	[名]
malanggv	[名]
malari	[形]
malfun	[形]
malgiyan	[名]
malhvxabumbi	[及]
malhvxambi	[及]
malhvxandumbi	[及]
malhvkan	[形]
malhvn	[形]
malhvngga	[形]
malhuaxanumbi	[及]
maljimbi	[及]
malta	[名]
malu	[名]
malukan	[形]
mama	[名]
mamfin	[名]
mamgiya	[名]
mamgiyabmnbi	[及]
mamgiyakv	[名]
mamgiyambi	[及]
mamgiyandumbi	[及]
mamgiyanumbi	[及]
mamnn	[名]
mampibumbi	[及]
mampilambi	[及]
mampimbi	[及]
mampin	[名]
mampingga	[形]
mamuha	[形]
mamuhan	[形]
mamuke	[名]
mamutun	[名]
mamyari	[名]
manabumbi	[及]
managa	[名]
managan	[名]
manahangge	[名]
manambi	[不及]
manashvn	[形]
manda	[形][名]
mandakan	[形]
mandal	[名]
mandara	[名]
mandarawa	[名]
mandebumbi	[及]
mandumbi	[不及]
mangg	[后]
mangga	[形]
manggaxacuka	[形]
manggaxambi	[不及]
manggaburu	[形]
manggai	[副]
manggakan	[形]
manggalame	[副]
manggangge	[名]
manggantu	[名]
manggasika	[名]
manggi	[连][副]
manggici	[副]
manggisup	[名]
manggiyan	[名]
manggiyanambi	[不及]
mangkan	[名]
mangkara	[形]
mani	[名]
manja	[名]
manju	[名]
manjurabumbi	[及]
manjusiri	[名]
mansui	[名]
maokala	[名]
marabumbi	[及]
marakv	[名]
marambi	[不及]
marandumbi	[不及]
maratambi	[不及]
mardun	[名]
margan	[名]
mari	[名]
mariaci	[名]
marian	[名]
maribumbi	[及]
marimbu	[名]
marin	[名]
maritai	[副]
marman	[名]
maru	[名]
marulambi	[不及]
marutu	[形]
masakv	[名]
masambi	[及]
masan	[名]
mase	[名]
maselakv	[名]
masflambi	[及]
masiri	[名]
mastlabumbi	[及]
matabuinbi	[及]
matalambi	[及]
matambi	[及]
matan	[名]
matangga	[形]
matarakv	[名]
matun	[名]
maya	[名]
mayalambi	[及]
mayambi	[不及]
mayambmnbi	[及]
mayan	[名]
me	[名]
mexembi	[及]
mede	[名]
medebumbi	[及]
medege	[名]
medegei	[名]
medehe	[名]
medembi	[不及]
medergu	[名]
mederi	[名]
medesi	[名]
megu	[名]
mehe	[名]
mehejen	[名]
mehen	[名]
meheren	[名]
mehete	[形]
mehubumbi	[及]
mehueni	[副]
mehumbi	[及]
meifehe	[名]
meifen	[名]
meihe	[名]
meihen	[名]
meihengge	[名]
meiherebumbi	[及]
meiherembi	[及]
meihetu	[名]
meijebumbi	[及]
meijembi	[不及]
meilebumbi	[及]
meilembi	[及]
meiren	[名]
meiretu	[名]
meisile	[名]
meita	[名]
meitebumbi	[及]
meitehe	[名]
meitembi	[及]
mejige	[名]
mejigexembi	[及]
mejigelebumbi	[及]
mejigelembi	[及]
mejin	[名]
mekcerembi	[不及]
meke	[名]
mekele	[副]
mekeni	[名]
mekenimbi	[及]
mekerebumbi	[及]
mekerembi	[及]
mekhembi	[不及]
mekitu	[名]
mektebumbi	[及]
mektembi	[及]
mekten	[名]
melbiku	[名]
melbimbi	[及]
melbin	[名]
melexetembi	[及]
melebumbi	[及]
melembi	[及]
melendumbi	[及]
melenembi	[及]
melenjimbi	[及]
melenumbi	[及]
melerhi	[名]
melerjembi	[及]
meljebumbi	[及]
melkexembi	[不及]
melken	[名]
melketu	[名]
melmembi	[不及]
melmen	[名]
melmenembi	[不及]
meme	[名]
memema	[名]
memeniye	[名]
memerxembi	[不及]
memereku	[名]
memerembi	[及]
memeren	[名]
menderembi	[不及]
mendzy	[名]
mene	[副]
menehun	[名]
meneksaka	[副]
menen	[形]
menerekengge	[形]
menerembi	[不及]
meng ki	[名]
mengde	[名]
mengdelembi	[及]
mengdzy	[名]
mengge	[形]
menggitu	[名]
menggun	[名]
mengse	[名]
mengseku	[名]
meni meni	[代][副]
meningge	[代]
menji	[名]
mentehe	[形]
mentu	[名]
mentuhudembi	[不及]
mentuhuken	[形]
mentuhun	[形]
mentuhurembi	[不及]
mere	[名]
meren	[名]
mergedembi	[及]
mergen	[名]
mergengge	[形]
merhe	[名]
merhebumbi	[及]
merhembi	[及]
merihan	[名]
merkimbi	[及]
merpingge	[形]
mersen	[名]
mersenembi	[不及]
mersengge	[形]
merseri	[名]
mersetu	[形]
metembi	[及]
metu	[名]
meungge	[名]
meye	[名]
meyelebumbi	[及]
meyelembi	[及]
meyen	[名]
meyengge	[形]
mixun	[数]
mibsehe	[名]
mibsehenembi	[不及]
miburi	[名]
miciha	[名]
micihiyan	[形]
micumbi	[不及]
midada	[名]
midaha	[名]
midaljambi	[不及]
midaltu	[名]
mieheo	[名]
mihacan	[名]
mihadambi	[不及]
mihan	[名]
mijirebumbi	[及]
mijirembi	[不及]
mijiri	[名]
mikcan	[名]
mila	[叹][形][名]
milahvn	[形]
milarabumbi	[及]
milaraburengge	[形]
milarambi	[不及]
milata	[形]
mimi	[名][状]
mimimbi	[及]
mimsoro	[名]
min ning	[名]
mindzy	[名]
ming	[名]
minggaci	[数]
minggada	[名]
minggaha	[名]
minggan	[数]
minggari	[名]
minggata	[数]
minggatu	[名]
minggunggeri	[数]
mingmiyaha	[名]
miningge	[名]
mioxhorombi	[不及]
miodori	[形]
miosihvdambi	[不及]
miosihvn	[形]
miosihodobumbi	[及]
miosihodombi	[及]
miosihon	[形]
miosiri	[副]
miosirilmnbi	[不及]
mise	[名]
misen	[名]
mishabumbi	[及]
mishaiarangge	[名]
mishalakv	[名]
mishalambi	[及]
mishambi	[不及]
mishan	[名]
misharangge	[不及]
misihiyadambi	[不及]
misu	[形]
misun	[名]
misuru	[名]
mita	[名]
mitabumbi	[及]
mitabume	[副]
mitandumbi	[及]
miyafibumbi	[名]
miyahv	[名]
miyalikv	[名]
miyalimbi	[及]
miyalin	[名]
miyamixakv	[名]
miyamixambi	[及]
miyamibumbi	[及]
miyamigan	[名]
miyamikv	[名]
miyamimbi	[及]
miyamin	[名]
miyanda	[名]
miyandzy	[名]
miyang	[状]
miyar	[状]
miyarha	[名]
miyaridambi	[不及]
miyarimbi	[不及]
miyasihi miyasihi	[形]
miyasihidambi	[不及]
miyasitambi	[不及]
miyegu	[名]
miyehudembi	[不及]
miyehunembi	[不及]
miyehusu	[名]
miyoxorobumbi	[及]
miyoxorombi	[不及]
miyoo	[名]
miyoocalambi	[及]
miyoocalanumbi	[及]
miyoocan	[名]
miyoociyang	[名]
miyoodzy	[名]
miyooehalandumbi	[及]
miyori	[名]
miyosirilambi	[不及]
mnxu	[名]
mo	[名][副]
moxuse	[名]
mobin	[名]
mobsehe	[名]
mociko	[形]
mocin	[名]
mocodombi	[不及]
modan	[名]
modo	[形]
moeho	[形]
mohobumbi	[及]
mohon	[名]
mohori sohori	[形]
mohotolo	[名]
mohume	[名]
mojihiyan	[名]
mokcombi	[不及]
moko	[名]
mokso	[副]
moksolombi	[及]
mokto	[名]
molho	[名]
moli	[名]
moliolo	[名]
molo	[名]
molodombi	[及]
molojin	[名]
moloma	[名]
molori	[名]
moltosi	[名]
momohon	[形]
momohori	[副]
momokon	[形]
momorxombi	[不及]
momorombi	[不及]
moncon	[名]
monggo	[名]
monggocon	[名]
monggolibumbi	[及]
monggolikv	[名]
monggolimbi	[及]
monggon	[名]
monggorobmnbi	[及]
monggorobumbi	[及]
monggorokv	[名]
monggorombi	[及]
monggorome	[副]
mongniohon	[形]
mongniorombi	[不及]
monio	[名]
moniocilambi	[不及]
monjixambi	[及]
monjibumbi	[及]
monjimbi	[及]
monjirxambi	[及]
monjirambi	[及]
moo	[名]
moo ihan	[名]
moodahvn	[名]
moodasi	[名]
moorho	[名]
moositun	[名]
mooyen	[名]
morici	[名]
morilabumbi	[及]
morilambi	[及]
morin	[名]
moringga	[名]
moro	[名]
morohon	[形]
morolombi	[不及]
morombi	[及]
moron	[名]
moselabumbi	[及]
moselakv	[名]
moselambi	[不及]
mosha	[名]
moshari	[名]
mosike	[名]
motoro	[名]
moyaci	[名]
moyo	[形][名]
moyobumbi	[及]
moyombi	[不及]
moyoro	[名]
mu	[名]
mu ye	[名]
muRhu	[形]
muxuhu	[名]
muxuhuri	[副]
muxurhu	[名]
muxuri	[名]
muca	[名]
mucejun	[名]
mucen	[名]
mucengge	[名]
mucesi	[名]
muciha	[名]
mucihiyan	[名]
mucitun	[形][名]
mucu	[名]
mucunggai	[形]
mudaci	[名]
mudacilambi	[不及]
mudafiyan	[名]
mudakiyambi	[及]
mudali	[副]
mudalikan	[形]
mudalimbi	[不及]
mudalin	[名]
mudamtun	[名]
mudan	[名]
mudandari	[名]
mudangga	[形]
mudari	[不及]
mudumbi	[及]
mudun	[名]
muduri	[名]
mudurikv	[名]
muduringga	[形]
mufi	[名]
mufuyen	[形]
mugku tongbo	[名]
muhvlu	[名]
muhaxan	[名]
muhaftyabumbi	[及]
muhaftyambi	[及]
muhaliyahangge	[形]
muhaliyan	[名]
muhan	[名]
muhantumbi	[不及]
muharxambi	[不及]
muhari	[名]
muhexembi	[及]
muheliyeken	[形]
muheliyen	[形]
muheliyengge	[形]
muheren	[名]
muheri	[形]
muhi	[名]
muhiyan	[名]
muhu	[名]
muhun	[名]
muhuru	[名]
mujakv	[副]
mujan	[名]
mujangga	[小]
muji	[名]
mujifimbi	[不及]
mujilen	[名]
mujilengge	[形]
mujin	[名]
mujingga	[形]
mujuhu	[名]
muk muk	[状]
mukvmbi	[及]
mukxalabmnbi	[及]
mukxalambi	[及]
mukxan	[名]
mukcuhun	[形]
mukdan	[名]
mukdehen	[名]
mukdehun	[名]
mukdehuri	[名]
mukdembi	[不及]
mukdembumbi	[及]
mukden	[名]
mukdendembi	[不及]
mukdenderengge	[形]
muke	[名]
mukelu	[名]
mukenembi	[不及]
mukeri	[名]
muki	[名]
mukiyebumbi	[及]
mukiyembi	[不及]
mukiyen	[名]
mukjambi	[不及]
mukjuri makjari	[状]
mukjuri mukjuri	[状]
muktehen	[名]
muktun	[名]
mulan	[名]
mulfiyen	[名]
mulhvri	[名]
muliyan	[名]
mulmen	[名]
multujembi	[不及]
multulembi	[及]
mulu	[名]
mulurambi	[及]
muluse	[名]
mumanambi	[不及]
mumerhen	[名]
mumin	[形]
mumuhu	[名]
mumurembi	[不及]
mumurhvn	[形]
mumuri	[形]
munahvn	[形]
munari	[名]
mung mang	[状]
munggan	[名]
mungge	[形]
mungkeri	[名]
mungku	[名]
mur mar	[状]
murakv	[形][名][副]
murakvngge	[形]
murambi	[不及]
muran	[名]
murca	[名]
murcakv	[名]
murcan	[名]
murfa	[名]
murhvn	[形]
murikv	[名]
murime	[副]
murin tarin	[状]
murinjambi	[不及]
murishvn	[名]
murkibumbi	[及]
murkimbi	[及]
murmnbi	[不及]
mursa	[名]
murtashvn	[形]
muru	[名]
muruxembi	[及]
muruxeme	[副]
murung	[名]
murungga	[形]
mus'ren	[名]
muse	[代]
musembi	[及]
musembumbi	[及]
musen	[名]
musengge	[名]
musha	[名]
musi	[名]
musiha	[名]
musihi	[名]
musumbi	[不及]
mutebukv	[名]
mutebumbi	[及]
muteburengge	[名]
mutehentu	[名]
mutembi	[及]
muten	[名]
mutengge	[形]
mutubumbi	[及]
mutulhen	[名]
mutumbi	[不及]
mutun	[名]
muwa	[形]
muwaxambi	[及]
muwaxame	[副]
muwakan	[形]
muwarungga	[形]
muya	[名]
muyahvn	[形]
muyambi	[不及]
muyari	[名]
na	[名]
na rhvngga	[形]
naaggin	[名]
nabalambi	[不及]
naca	[名]
naceo	[名]
nacihiyabumbi	[及]
nacihiyambi	[及]
nacin	[名]
nadaci	[数]
nadacingge	[数]
nadan	[数]
nadanci	[数]
nadangga	[数]
nadanggeri	[数]
nadanju	[数]
nadanjute	[数]
nadase	[名]
nadata	[数]
nagan	[名]
nagga	[名]
nahere	[形]
nai ggu	[名]
naihv	[名]
naihvmbi	[不及]
naihvrangge	[名]
naiji	[名]
naimisun	[名]
nainai	[名]
nairahvn	[形]
najihiyan	[名]
nakv	[不及]
nakabumbi	[及]
nakcu	[名]
nalu	[名]
namxuri	[名]
nama	[名]
namaxan	[后]
namakv	[名]
namalambi	[及]
naman	[名]
namarabumbi	[及]
namarambi	[不及]
namburelambi	[不及]
namdv	[名]
namgin	[名]
nami	[名]
namki	[名]
namu	[名]
namun	[名]
namuri	[名]
namusi	[名]
nan	[名]
nan ging	[名]
nanda	[名]
nandabumbi	[及]
nandambi	[及]
nanggv	[名]
nanggixambi	[不及]
nanggitu	[形]
nantuhvn	[形]
nantuhvrambi	[及]
naraxambi	[及]
naracuka	[形]
naracun	[名]
narahvnjambi	[不及]
narambi	[及][不及]
naranggi	[副]
narga	[名]
nargambi	[及]
narhvxabumbi	[及]
narhvdambi	[不及]
narhvn	[形]
nari	[名]
narintu	[名]
nasabumbi	[及]
nasacuka	[形]
nasacun	[名]
nasambi	[不及]
nasan	[名]
nasandumbi	[不及]
nashvlabumbi	[及]
nashvlabun	[名]
nashvlambi	[及]
nashvn	[名]
nasin	[名]
nasucungga	[形]
natsbin	[名]
naya	[名]
ne	[形][名]
nece	[名]
necihiyen	[形]
neciken	[形]
necimbi	[及]
necin	[形]
necinembi	[及]
necingge	[形]
necinjimbi	[及]
necintu	[形]
nege	[名]
negelembi	[不及]
nehv	[名]
nehvji	[名]
nei	[名]
neibuntu	[形]
neibushvn	[形]
neigecilebumbi	[及]
neigecilembi	[及]
neigelembi	[及]
neigen	[形]
neigenjebumbi	[及]
neigenjembi	[及]
neiku	[形]
neilebukv	[名]
neilebun	[名]
neilembi	[及]
neilen	[名]
neileshvn	[名]
neimbi	[及]
nekcu	[名]
nekeliyeken	[形]
nekeliyelembi	[及]
nekeliyelenembi	[及]
nekeliyen	[形]
neku	[名]
nekulambi	[及]
nekulembi	[及]
nelhe	[形]
nemxeku	[名]
nemxembi	[及]
nemebumbi	[及]
nemegin	[名]
nemehen	[名]
nemeku	[形]
nemembi	[及][不及]
nememe	[副]
nemerhen	[名]
nemeri	[形]
nemerku	[名]
nemeyeken	[名]
nemeyen	[形]
nemgiyen	[形]
nemkibumbi	[及]
nemkimbi	[及]
nemselembi	[不及]
nemsuri	[形]
nemu	[名]
nendebmnbi	[及]
nenden	[名]
nenembi	[不及]
neneme	[副]
nengceri	[形]
nengge	[名]
nenggelebumbi	[及]
nenggeleku	[名]
nenggelembi	[及]
nenggereshun	[形]
neniyen	[名]
neombi	[不及]
nere	[名]
nereku	[名]
nerembi	[及]
nergabumbi	[及]
nergi	[形]
nergin	[名]
nergingge	[形]
nerkimbi	[及]
nesi	[名]
nesidun	[名]
nesuken	[形]
netsihiyembi	[及]
neye	[名]
neyen	[名]
ni	[小]
ni /l	[名]
ni xan	[名]
ni xui jiyang	[名]
nixa	[形][副]
nixalambi	[及]
nixan	[名]
nixargan	[名]
nixe	[名]
nixumbumbi	[及]
nibcu	[名]
nicangga	[形]
nicuxambi	[不及]
nicuhe	[名]
nicuheri	[形]
nicumbi	[不及]
nicun	[形]
nidumbi	[不及]
nijarabumbi	[及]
nijarakv	[名]
nijarambi	[及]
niji	[名]
nijihe	[名]
nikacilambi	[不及]
nikai	[小]
nikan	[名]
nikan /l	[名]
nikarabumbi	[及]
nikarambi	[不及]
nikde	[名]
nikexembi	[不及]
nikebuku	[名]
nikebun	[名]
nikedembi	[不及]
nikeku	[名]
nikekungge	[形]
nikembi	[不及]
nikembi /l	[不及]
niken	[名]
nikendumbi	[不及]
nikenembi	[不及]
nikenjimbi	[不及]
niketu	[名]
niksimbi	[不及]
niktan	[名]
niktembi	[及]
nikton	[名]
niktongga	[形]
nilabumbi	[及]
nilakv	[名]
nilambi	[及]
nilgiyan	[形]
nilgiyangga	[名]
nilhvdambi	[不及]
nilhvma	[名]
nilhvn	[形]
nilhi	[名]
niltajambi	[不及]
niltubumbi	[及]
niltumbi	[及]
nilukan	[形]
nimaxakv	[名]
nimaxan	[名]
nimaxan /l	[名]
nimaca	[名]
nimaci	[名]
nimada	[名]
nimadan	[名]
nimaha	[名]
nimahaxambi	[及]
nimalan	[名]
niman	[名]
niman /l	[名]
nimanggi	[名]
nimargan	[名]
nimari	[形]
nimasi	[名]
nimatun	[名]
nimebumbi	[及]
nimecuke	[形]
nimecukengge	[名]
nimeku	[名]
nimekulembi	[不及]
nimekungge	[形]
nimembi	[不及]
nimenggi	[名]
nimenggilembi	[及]
nimetembi	[不及]
nimheliyen	[形]
nincuhvn	[形]
ningceo	[名]
ningcu	[名]
ningdan	[名]
ningdangga	[形]
ninggiya	[名]
ninggu	[方]
ningguci	[数]
ninggucingge	[名]
ninggun	[数]
ninggureme	[后]
ningguta	[名]
ninggute	[数]
ningkabumbi	[不及]
niniyarxambi	[不及]
niniyarambi	[不及]
niniyarilambi	[不及]
ninju	[数]
ninjuci	[数]
ninjute	[数]
ninkimbi	[及]
nintehe	[形]
nintuhv	[形]
ninuri	[名]
nio	[小]
nioxuhulembi	[不及]
niobihe	[名]
niobombi	[及]
nioboro	[形]
niohan	[名]
niohe	[名]
nioheri	[名]
niohobumbi	[及]
niohokon	[形]
niohombi	[及]
niohon	[形]
niohuxulebumbi	[及]
niohuxulembi	[不及]
niohuxun	[形]
niohubumbi	[及]
niohuken	[形]
niohumbi	[及]
niohun	[形]
niojan	[形]
niokan	[名]
niokji	[名]
niokso	[名]
niolhucembi	[不及]
niolhumbi	[及]
niolhumbumbi	[及]
niolhun	[形][名]
niolhundambi	[不及]
niolmon	[名]
niolmongge	[形]
niolmonggi	[名]
niolocuka	[形]
niolombi	[不及]
niombi	[不及]
niomere	[名]
niomoxon	[名]
nionggalambi	[及]
nionggjambi	[不及]
niongnio	[名]
niongniyaha	[名]
nionio	[名]
nionioru	[名]
niorombi	[不及]
niorombumbi	[及]
nioron	[名]
nioronggo	[形]
niosha	[名]
niowancihiyan	[名]
niowangga	[形]
niowanggiyakan	[形]
niowanggiyan	[形]
niowaniori	[形]
niowargi	[形]
niowari	[形]
niowarixambi	[不及]
niowariha	[名]
niowarikv	[名]
niowarimbu	[形]
nirehe	[名]
nirfa	[名]
nirga	[形]
nirgakan	[形]
nirgangge	[名]
nirhvwatu	[名]
nirkimbi	[及]
niru	[名]
nirubumbi	[及]
nirugan	[名]
nirumbi	[及][不及]
nirungge	[形]
nirwan	[名]
nisabumbi	[及]
nisakv	[名]
nishu	[形]
nisiha	[名]
nisihai	[副]
nisikte	[名]
nisumbi	[不及]
nisundumbi	[不及]
nisuri	[名]
nitan	[形]
nituri	[形]
niyabumbi	[及]
niyada	[形]
niyadaha	[名]
niyahaxabumbi	[及]
niyahaxambi	[不及]
niyahan	[名]
niyahara	[名]
niyaharanambi	[不及]
niyahari	[名]
niyaharnambi	[不及]
niyahasbambi	[及]
niyaihvnjambi	[不及]
niyajiba	[名]
niyakvn	[名]
niyakvrabumbi	[及]
niyakvrambi	[不及]
niyaki	[名]
niyakinabumbi	[及]
niyakinambi	[不及]
niyakitu	[名]
niyalma	[名]
niyalmaingge	[名]
niyamaxan	[名]
niyamala	[名]
niyamalambi	[及]
niyaman	[名]
niyamanambi	[不及]
niyamangga	[形]
niyamani	[名]
niyamarambi	[不及]
niyamarcambi	[不及]
niyamari	[名]
niyambi	[不及]
niyambulu	[名]
niyamciri	[名]
niyamju	[名]
niyamniyabumbi	[及]
niyamniyambi	[及]
niyamniyan	[名]
niyamniyanambi	[及]
niyamniyandumbi	[及]
niyamniyanumbi	[及]
niyan ggan dzy	[名]
niyancakv	[名]
niyancambi	[及]
niyancan	[名]
niyancanggangge	[名]
niyancari	[名]
niyanci	[名]
niyanciha	[名]
niyanciri	[形]
niyandzy	[名]
niyanehangga	[形]
niyang dze	[名]
niyang niyang	[名]
niyangdze	[名]
niyangdzy	[名]
niyanggvbumbi	[及]
niyanggvmbi	[及]
niyanggu	[名]
niyangniya	[名]
niyangniyahvn	[形]
niyangniyang	[名]
niyangniyarambi	[不及]
niyaningjiji	[名]
niyaniombi	[及]
niyaniyarilambi	[不及]
niyaniyun	[名]
niyanjan	[名]
niyanjari	[形]
niyara	[名]
niyaran	[名]
niyarangga	[形]
niyarhvkan	[形]
niyarhvlambi	[不及]
niyarhoca	[名]
niyarhuan	[形]
niyari	[名]
niyase	[名]
niyasha	[名]
niyasi	[名]
niyasubi	[不及]
niyasubumbi	[不及]
niyecebumbi	[及]
niyecebun	[名]
niyececun	[名]
niyecembi	[不及]
niyecen	[名]
niyecetembi	[及]
niyegniyeltu	[形]
niyehe	[名]
niyei pan	[名]
niyekdecuke	[形]
niyekdembi-ke	[不及]
niyekeje	[名]
niyekinambi	[不及]
niyekje	[名]
niyekse	[形]
niyeksembi	[不及]
niyekserhen	[名]
niyelebumbi	[及]
niyelejembi	[不及]
niyeleku	[名]
niyelembi	[及]
niyemperembi	[不及]
niyengceri	[形]
niyenggari	[形]
niyenggweri	[形]
niyengniyeletu	[形]
niyengniyeri	[名]
niyengniyerikten	[名]
niyengniyertu	[形]
niyeniye	[形][名]
niyeniyehudembi	[不及]
niyeniyehun	[形]
niyeniyehunjembi	[不及]
niyeniyerxembi	[及]
niyere	[形]
niyerebambi	[及]
niyereken	[形]
niyerembi	[及][不及]
niyerengge	[形]
niyo	[名]
niyobumbi	[及]
niyociki	[名]
niyohombi	[不及]
niyokdoko	[名]
niyokso	[名]
niyolodo	[形]
niyombi	[及]
niyoolocuka	[形]
niyorombi	[不及]
nlaktacun	[名]
no da	[名]
noho	[小]
nokai	[副]
nokcimbi	[不及]
nomhokon	[形]
nomhon	[形]
nomin	[名]
nomulambi	[及]
nomun	[名]
non	[名]
nonggari	[名]
nonggibun	[名]
nonggimbi	[及]
nongginambi	[及]
nonggindumbi	[及]
nonggingga	[形]
nongginjimbi	[及]
nono	[名]
noor	[名]
norambi	[及]
noran	[名]
noro	[名]
norobumbi	[及]
noron	[名]
nosiki	[名]
notho	[名]
noyau	[名]
nu	[名]
nuhakan	[形]
nuhaliyan	[形]
nuhan	[形]
nuhasi	[名]
nuheci	[名]
nuhen	[名]
nuhere	[形][名]
nuhu	[形]
nujaxambi	[及]
nujalambi	[及]
nujan	[名]
nujangga	[形]
nukacuka	[形]
nukajambi	[不及]
nukambi	[不及]
nukcimbi	[不及]
nukcishun	[形]
nukimbi	[不及]
nukte	[名]
nuktebumbi	[及]
nuktembi	[不及]
nuktendumbi	[不及]
nuktenembi	[不及]
nuktenjimbi	[不及]
nuktenumbi	[不及]
nunggalambi	[及]
nunggari	[名]
nunggasun	[名]
nunggele	[名]
nunggembi	[及]
nungnecun	[名]
nungneku	[及]
nungnembi	[及]
nungneri	[形]
nunjibumbi	[及]
nuran	[名]
nure	[名]
nurhvmbi	[不及]
nurhaci	[名]
nushumbi	[及]
nuturu	[名]
o	[叹][名][小]
o xo	[状]
o guwa	[名]
oxo	[名]
oxoho	[名]
oxoholombi	[及]
oxonggo	[形]
oa	[状]
obdombi	[不及]
obgiya	[名]
obihiya	[形]
obo	[名]
obobumbi	[及]
obokv	[名]
oboko	[名]
obombi	[及]
obonggi	[名]
obongginambi	[不及]
obonggo	[形]
obonjimbi	[及]
obonombi	[及]
obumbi	[及]
oca	[名]
ocan	[名]
oci	[小][连]
ocibe	[连]
ocir	[名]
oden	[名]
ododon	[名]
odoli	[名]
odontu	[形]
odze	[名]
ofi	[名][连]
ofingge	[名]
ofio	[小]
ofoho	[名]
oforo	[名]
oforodombi	[及]
oforonggo	[形]
ogv	[名]
ogo	[名]
oho	[名]
ohode	[连]
oholiyo	[名]
oholiyombi	[及]
oholji	[名]
oholjombi	[及]
oholjon	[名]
ohorxambi	[不及]
ohorxombi	[不及]
ohotono	[名]
oi	[叹]
oibombi	[不及]
oibumbi	[不及]
oifo	[形]
oifu	[形]
oihori	[形]
oihorilambi	[及][不及]
oilo	[方]
oilohodombi	[不及]
oilohon	[形]
oilokon	[形]
oilon	[名]
oilorgi	[方]
oilori	[方]
oiombi	[不及]
oitobumbi	[不及]
ojin	[名]
ojojo	[叹]
ojomgi	[及]
ojorolame	[副]
ok	[状]
okcilabumbi	[及]
okcilambi	[及]
okcin	[名]
okcingga	[形]
okdobumbi	[及]
okdombi	[及]
okdomo	[名]
okdonggo	[形]
okdonjimbi	[及]
okdonobumbi	[及]
okdonombi	[及]
okdonumbi	[及]
okdori	[名]
oke	[名]
oki	[形]
okjiha	[名]
okjihada	[名]
okjoslambi	[不及]
oksimbi	[不及]
oksobumbi	[及]
oksombi	[不及]
okson	[名]
oksonjombi	[不及]
oksunjombi	[不及]
oktalambi	[及]
oktaron	[名]
okto	[名]
oktolombi	[及]
oktorohon	[名]
oktoron	[名]
oktosi	[名]
oktosilabumbi	[及]
oktosilambi	[及]
olbihiyan	[形]
olbo	[名]
olboro	[形]
olfihiyan	[形]
olhoxombi	[及]
olhoxon	[形]
olhoba	[形]
olhobangge	[名]
olhobumbi	[及]
olhocuka	[形]
olhocun	[名]
olhokon	[形]
olhombi	[不及]
olhon	[形][名]
olhotun	[名]
oliha	[形]
olihadambi	[不及]
olihari	[名]
olimbi	[及]
olji	[名]
oljilambi	[及]
olo	[名]
oloxon	[名]
olobumbi	[及]
olohoi	[叹]
olombi	[及]
olon	[名]
olongdo	[名]
olosi	[名]
omxon	[名]
ombi	[不及]
omcoko	[名]
omi	[形]
omibumbi	[及]
omicambi	[及]
omiholobumbi	[及]
omiholombi	[不及]
omihon	[形]
omilabumbi	[及]
omilambi	[及]
omimbi	[及]
omin	[名]
ominambi	[及]
omingga	[名]
ominjimbi	[及]
omkiya	[名]
omo	[名]
omoho	[名]
omoktu	[名]
omolo	[名]
omosi	[名]
on	[名]
onasu	[名]
onco	[形]
oncodobumbi	[及]
oncodombi	[及]
oncohoxombi	[不及]
oncohon	[形]
oncokon	[形]
ondombi	[不及]
ong	[状]
onggoxon	[名]
onggobumbi	[及]
onggocon	[名]
onggola	[名]
onggolo	[形][名]
onggolo3	[后]
onggolokon	[形]
onggombi	[及]
onggon	[名]
onggoro	[名]
onggosu	[名]
onggotai	[副]
ongkimbi	[不及]
ongko	[名]
ongnika	[名]
ongton	[形]
ongtori	[名]
onon	[名]
ooca	[名]
oodze	[名]
ooha	[名]
oombi	[不及]
oori	[名]
ooron	[名]
or	[状]
ora	[名]
ordo	[名]
oren	[名]
orgi	[名]
orgilambi	[及]
orho	[名]
orhoco	[形]
orhoda	[名]
orhon	[名]
ori	[名]
orima	[名]
orimbi	[不及]
orin	[数]
orinci	[数]
orinta	[数]
orobumbi	[及]
orokv	[名]
orolombi	[及][不及]
orombi	[及]
oromu	[名]
oron	[名][副]
oronco	[名]
oronggo	[名]
oros	[名]
orsocuka	[形]
orson	[名]
orume	[名]
oshodombi	[及]
oshon	[形]
osohokon	[形]
osohon	[形]
osokon	[形]
otgo	[名]
otho	[名]
otok	[名]
otokon 	[名]
oton	[名]
otori	[名]
otorilambi	[及]
oyo	[名]
oyo oyo	[状]
oyobumbi	[及]
oyoki	[形]
oyomeliyan	[形]
oyon	[名]
oyonggo	[形]
oyonggon	[名]
oyonggongge	[名]
oyotonggo	[形]
oyoyo	[叹]
pRu	[名]
page	[名]
pai	[名]
pai dzoo	[名]
pai siyoo	[名]
pailu	[名]
pailuri	[名]
pak	[状]
palta	[名]
paltari	[名]
pampahvn	[形]
pampu	[名]
pan	[名]
pan guwan	[名]
pancalambi	[不及]
pancan	[名]
pandze	[名]
panggiya	[名]
panghai	[名]
pangse	[名]
pangtongga	[名]
panse	[名]
par par	[状]
parpahvn	[形]
parpanambi	[不及]
parsu	[名]
pas	[状]
pata	[状]
patak	[状]
patar pitir	[状]
pei	[叹]
pekte pakta	[状]
pelehen	[名]
pelembi	[及]
pelerjembi	[不及]
peng	[名]
peng to	[名]
pengduwan	[名]
per par	[状]
per pir	[状]
pes	[状]
pi xuwang	[名]
picik pacak	[状]
picir	[状]
pijan	[名]
pilembi	[及]
pilgican	[名]
pilu	[名]
pilutu	[名]
pimpinambi	[不及]
pin	[名]
ping	[名][状]
ping di jeo	[名]
pinggari	[名]
pinggiyen	[名]
pinggu	[名]
pingguri	[名]
pingpi	[名]
pingse	[名]
pingselebumbi	[及]
pingselembi	[及]
pio	[状]
pipa	[名]
pipuri	[名]
piyak	[状]
piyas	[状]
piyat piyat	[状]
piyata	[名]
piyatang	[状]
piyatar	[状]
piyoo	[名]
piyoociyan	[名]
pocok	[状]
pocong	[状]
podze	[名]
pojan	[名]
pok	[状]
pokcohon	[形]
pokita	[名]
poksohon	[形]
poksohori	[形]
polori	[名]
pongcun	[形]
pongtonombi	[不及]
poo	[名]
popuri	[名]
porong	[状]
porpa	[状]
porpon parpan	[状]
porponohobi	[不及]
pos	[状]
potor patar	[状]
pu	[名][状]
pu dun tai	[名]
puxeli	[名]
pudanai	[名]
puhv	[名]
puk	[状]
pul	[名]
pulu	[名]
pulu pala	[状]
pun	[名]
pur	[状]
purpui	[名]
pus	[状]
pusa	[名]
puse	[名]
putu pata	[状]
putur	[状]
xvrgeku	[名]
xa	[名]
xaxambi	[不及]
xaxan	[名]
xaxanjambi	[不及]
xaxun	[名]
xaxunakv	[形]
xab	[状]
xaban	[名]
xabargan	[名]
xabi	[名]
xabinar	[名]
xabjunio	[名]
xabtun	[名]
xabtungga	[形]
xaburambi	[不及]
xaburu	[形]
xacambi	[不及]
xacun	[名]
xacungga	[形]
xada	[形]
xadabumbi	[及]
xadacuka	[形]
xadali	[名]
xadambi	[不及]
xadashvn	[形]
xadu	[名]
xaduhv	[名]
xaggu	[名]
xahvkan	[形]
xahvn	[形]
xahvrabumbi	[及]
xahvrambi	[不及]
xahvrun	[形]
xahvrungga	[形]
xahaltu	[名]
xahasi	[名]
xahtu	[名]
xaji	[名]
xajilan	[名]
xajin	[名]
xajingga	[形]
xajintu	[名]
xajiri	[形]
xak	[状]
xakxahvn	[形]
xakxaha	[名]
xakxahalambi	[不及]
xakxaljambi	[不及]
xakxan	[名]
xakxari	[形]
xakxarjambi	[不及]
xaka	[名]
xakaxabumbi	[不及]
xakaxambi	[不及]
xakafi	[名]
xakalambi	[及]
xakanambi	[不及]
xaktalambi	[及]
xala	[名]
xalangtu	[名]
xalar	[状]
xalhvma	[名]
xalibumhi	[不及]
xambi	[及][不及]
xami	[名]
xampi	[名]
xampilabmnbi	[及]
xampilambi	[及]
xan	[名]
xanaha	[名]
xancilambi	[不及]
xancin	[名]
xandu	[名]
xandumbi	[不及]
xandung	[名]
xang	[名]
xang xu	[名]
xang tui guwan	[名]
xangxaha	[名]
xangga	[形]
xanggabumbi	[及]
xanggambi	[不及]
xanggan	[名]
xanggatai	[副]
xanggin	[名]
xanggiyakv	[名]
xanggiyakan	[形]
xanggiyambi	[不及]
xanggiyan	[形][名]
xanggiyari	[名]
xangguhe	[名]
xangkvra	[名]
xangka	[名]
xangkan	[名]
xangnahan	[名]
xangnambi	[不及]
xangsi	[名]
xangsin	[名]
xanio	[名]
xaniori	[名]
xaniri	[名]
xaniya	[名]
xaniyalhan	[形]
xaniyambi	[不及]
xaniyangga	[形]
xansi	[名]
xanumbi	[不及]
xanyakan	[形]
xanyan	[形][名]
xanyangga	[形]
xanyo	[名]
xaping	[名]
xar	[状]
xara	[副]
xarahvmbi	[不及]
xarambi	[不及]
xari	[形][名][状]
xarixambi	[不及]
xaribudari	[名]
xaribumbi	[及]
xariltu	[名]
xarimbi	[及]
xaringga	[形]
xaringgiyabumbi	[及]
xaringgiyambi	[及]
xarinjambi	[不及]
xarki	[名]
xarman	[名]
xartan	[名]
xaru	[名]
xaruk	[名]
xasixambi	[不及]
xasihaxambi	[及]
xasihalabumbi	[不及]
xasihalambi	[及]
xasihan	[名]
xatan	[名]
xatubumbi	[不及]
xatumbi	[及]
xaturnambi	[不及]
xayo	[名]
xayolambi	[及]
xayu	[名]
xe	[名]
xe ba	[名]
xexembi	[及]
xexempe	[名]
xexenembi	[不及]
xexeri	[名]
xeben	[名]
xebnio	[名]
xebtembi	[不及]
xegkitu	[名]
xehuken	[形]
xehun	[形]
xeji	[名]
xejilebumbi	[及]
xejilembi	[及]
xekembi	[不及]
xelbori	[名]
xelembi	[及]
xelemo	[名]
xelen	[名]
xempi	[名]
xempilebumbi	[不及]
xempilembi	[及]
xen yang	[名]
xeng	[名]
xeng cai	[名]
xengge	[形]
xenggeci	[形]
xenggehen	[名]
xenggen	[形]
xenggetu	[名]
xenggetungge	[形]
xenggin	[名]
xenggintu	[名]
xenggiyen	[形]
xengkiri	[名]
xengsin	[名]
xentu	[名]
xentuhen	[名]
xeo	[名][状]
xeo ben	[名]
xeobei	[名]
xeoben	[名]
xeolebumbi	[不及]
xeolembi	[及]
xeolen	[名]
xercembi	[不及]
xerembi	[及]
xerembumbi	[不及]
xerentumbi	[及]
xeri	[名]
xeribumbi	[不及]
xerikulebumbi	[不及]
xerimbi	[及]
xerin	[名]
xeringgiyembi	[及]
xerinju	[名]
xerke	[名]
xersen	[形]
xertu	[名]
xeterxembi	[不及]
xeterembi	[不及]
xetuhen	[名]
xetumbi	[及]
xeyehen	[形]
xeyeke	[名]
xeyeken	[形]
xeyen	[形]
xeyen hiyaban	[名]
xi	[名][数]
xi ging	[名]
xi giyan taigiyan	[名]
xi ioi	[名]
xi ju	[名]
xidu	[名]
xidzy	[名]
xifu	[名]
xigemuni fucihi	[名]
xigiyang	[名]
xilgiyan	[名]
xilio	[名]
xoxohvn	[名]
xoxohon	[名]
xoxokv	[名]
xoxombi	[及][不及]
xoxon	[名]
xoxonggo	[形]
xoxosi	[名]
xobin	[名]
xobkoxombi	[不及]
xobumbi	[及]
xodan	[名]
xodobumbi	[及]
xodokv	[名]
xodombi	[及][不及]
xofor	[状]
xoforxombi	[及]
xoforo	[名]
xoforobumbi	[及]
xoforodz	[名]
xoforofi	[及]
xoforonggo	[形]
xofoyon	[形]
xoge	[名]
xohan	[名]
xoho	[名]
xohodombi	[不及]
xokv	[名]
xokxohon	[形]
xokxolimbi	[及]
xokin	[名]
xoli	[形]
xolingho	[名]
xolo	[名]
xolombi	[不及]
xolon	[名]
xolonggo	[形]
xolontu	[名]
xombi	[及]
xongge	[形]
xongkon	[名]
xongkoro	[名]
xonto	[名]
xontohojombi	[不及]
xonumbi	[及]
xoo	[名]
xooxi	[名]
xooboo	[名]
xoofu	[名]
xooge	[名]
xor	[状]
xorengge	[形]
xorgimbi	[及]
xorginambi	[及]
xorgindumbi	[及]
xorginjimbi	[及]
xorginumbi	[及]
xorho	[名]
xori	[名]
xorimbi	[及]
xoro	[名]
xoron	[名]
xoronggo	[形]
xosiki	[形][名]
xosin	[名]
xositun	[名]
xoyobumbi	[及]
xoyohvn	[形]
xoyoljombi	[不及]
xoyoshvn	[形]
xu	[名]
xu xa	[状]
xu ilha	[名]
xuxebumbi	[及]
xuxembi	[及]
xuxu	[形]
xuxu xaxa	[状]
xuxun	[形]
xuxungge	[形]
xuxunggiyambi	[不及]
xuxunjambi	[不及]
xuxurgan	[形]
xuxurgangga	[形]
xuxuri	[名]
xuxuri macari	[状]
xuban	[名]
xubumbi	[及]
xuburxembi	[不及]
xuburembi	[不及]
xuburi	[形]
xuceri	[形]
xuci	[形]
xucilembi	[不及]
xudacan	[形]
xudangga	[形]
xudembi	[不及]
xudesi	[名]
xudu	[名]
xudubumbi	[及]
xudumbi	[及]
xuduran	[名]
xudze	[名]
xufa	[名]
xufambi	[及]
xufan	[名]
xufanambi	[不及]
xufangga	[形]
xufari	[名]
xufasu	[名]
xufatu	[名]
xufin	[名]
xufurxembi	[不及]
xugi	[名]
xugilebumbi	[及]
xugilembi	[及]
xugin	[名]
xugingge	[形]
xugiri	[形]
xuhvra	[名]
xuhon	[形]
xuhudu	[名]
xuhuri	[名]
xui hiyang huwa	[名]
xui jing	[名]
xukxuhun	[形]
xukdun	[名]
xukixambi	[不及]
xukibumbi	[及]
xukilabumbi	[不及]
xukilambi	[不及]
xukimbi	[不及]
xukin	[名]
xuku	[名]
xukumbi	[不及]
xukun	[名]
xula	[名]
xulaburu	[形]
xulderi	[名]
xulebumbi	[及]
xulehelembi	[及]
xulehen	[名]
xulembi	[及]
xulhv	[名]
xulhe	[名]
xulheri	[名]
xulhumbi	[不及]
xulihun	[形]
xulimbi	[不及]
xulin	[名]
xulmen	[名]
xulu	[名]
xulumbi	[及]
xuman	[名]
xumbi	[不及]
xumci	[形]
xumgan	[名]
xumgiya	[形]
xumhun	[名]
xumikan	[形]
xumilambi	[及]
xumpulu	[形]
xun	[名]
xunembi	[不及]
xung	[状]
xungxun	[状]
xungga	[形]
xunggaci	[形]
xunggayan	[形]
xungge	[形]
xunggeri	[形]
xunggidei	[名]
xunggin	[形]
xunggiya	[形]
xunggiyada	[形]
xunggiyambi	[及]
xunggiyan	[形]
xungkebi	[不及]
xungkeci	[形]
xungken	[名]
xungkenembi	[不及]
xungkeri	[形]
xungku	[名]
xungkubumbi	[及]
xungkulu	[名]
xungkumbi	[不及]
xungkuri	[形]
xungkutu	[形]
xuntuhuni	[形]
xuo	[副]
xurain	[形]
xurdebuku	[名]
xurdehen	[形]
xurdeku	[名]
xurdeme	[后][方]
xurga	[名]
xurgambi	[不及]
xurgan	[名]
xurgebumbi	[不及]
xurgecembi	[不及]
xurgei	[名]
xurgembi	[不及]
xurhv	[名]
xurhvn	[名]
xurha	[名]
xurteku	[名]
xuru	[形][名]
xurubumbi	[及][不及]
xuruci	[名]
xurukv	[名]
xurumbi	[及]
xurun	[名]
xusai	[名]
xusebuku	[名]
xusembi	[不及]
xusha	[名]
xusi	[名]
xusige	[名]
xusiha	[名]
xusihaxambi	[不及]
xusihalambi	[及]
xusihe	[名]
xusihiyembi	[不及]
xusilebumbi	[不及]
xusilembi	[及]
xusin	[名]
xusiniyambi	[不及]
xusintu	[名]
xusu	[名]
xusungga	[形]
xutucin	[名]
xutugi	[形]
xutumbi	[不及]
xuwa	[名]
xuwai	[名][状]
xuwak	[状]
xuwar	[状]
xuwarxuwan	[名]
xuwarang	[形]
xuwarkiyalabumbi	[及]
xuwarkiyalambi	[及]
xuwarkiyan	[名]
xuwase	[名]
xuwaselambi	[及]
xuwe	[副]
xuwefun	[名]
xuyen	[名]
svna	[名]
sa	[名]
sabcirambi	[不及]
sabda	[名]
sabdambi	[不及]
sabdan	[名]
sabdangga	[形]
sabi	[名]
sabingga	[形]
sabintu	[名]
sabintungga	[形]
sabirambi	[不及]
sabirgan	[名]
sabirgi	[名]
sabiri	[形]
sabitun	[名]
sabka	[名]
sabkalambi	[不及]
sabke saka	[副]
sabsibumbi	[及]
sabsimbi	[及]
sabta	[名]
sabtarambi	[不及]
sabtari	[名]
sabu	[名]
sabubumbi	[及]
sabugan	[名]
sabula	[名]
sabumbi	[及]
sabunambi	[及]
sabundumbi	[及]
sabunjimbi	[及]
sabunumbi	[及]
saca	[名]
sacalabumbi	[及]
sacalambi	[及]
sacalandumbi	[及]
sacalanumbi	[及]
sacibumbi	[及]
sacima	[名]
sacimbi	[及]
sacimri	[形]
sacindumbi	[及]
sacinumbi	[及]
sacirambi	[及]
sacu	[名]
sacurambi	[及]
sada	[名]
sadfikv	[名]
sadulambi	[及]
sadun	[名]
sagin	[名]
saha	[名]
sahabumbi	[及]
sahadabumbi	[及]
sahadambi	[及]
sahahvkan	[形]
sahahvn	[形]
sahahvri	[形]
sahalca	[名]
sahaldai	[名]
sahaliyakan	[形]
sahaliyan	[形]
sahalja	[名]
sahaltu	[名]
sahambi	[及]
sahamha	[名]
sahan	[名]
saharabumbi	[及]
saharambi	[及]
sahari	[名]
sahiba	[名]
saixabukv	[名]
saixabumbi	[及]
saixacuka	[形]
saixakvxambi	[及]
saixambi	[及]
saixandumbi	[及]
saixanumbi	[及]
saibigan	[名]
saibihan	[名]
saiburu	[名]
saicungga	[形]
saidaha	[名]
saifa	[名]
saifatu	[名]
saifi	[名]
saifilambi	[及]
saihvwa	[名]
saihvwada	[名]
saihvwadalabumbi	[及]
saihvwadalambi	[及]
saiha	[名]
saikv	[名]
saikan	[形]
saimbi	[及]
saimengge	[形]
sain	[形]
saina：	[名]
saingge	[形]
saintu	[名]
sainumbi	[及]
saisa	[名]
saisaha	[名]
saise	[名]
saisha	[名]
saishan	[名]
saitu	[名]
saiyvn	[小]
saja	[数]
sajingga	[形]
sakvra	[名]
saka	[名][后]
sakalambi	[不及]
sakda	[名]
sakdabumbi	[及]
sakdaki	[形]
sakdambi	[不及]
sakdandambi	[不及]
sakdanumbi	[不及]
sakidun	[名]
saksahvn	[名]
saksaha	[名]
saksalabumbi	[不及]
saksalibumbi	[及]
saksalikv	[名]
saksan	[名]
saksari	[副]
saksin	[名]
saksu	[名]
saksulambi	[及]
sala	[名]
salaba	[名]
salabumbi	[及]
salambi	[及]
salamimbi	[及]
salanambi	[及]
salandumbi	[及]
salanjimbi	[及]
salgabumbi	[不及]
salgabun	[名]
salgatu	[名]
salhv	[名]
salhvma	[名]
salibumbi	[及]
saligan	[形][名]
salimbi	[及]
salingga	[形]
saliyahan	[形]
saliyan	[形]
salja	[名]
salmandara	[名]
salu	[名]
salungga	[形]
samaxambi	[不及]
samadi	[名]
saman	[名]
samandabidara	[名]
samangga	[形]
samarambi	[及]
samaran	[名]
sambarxame	[副]
sambi	[及]
sambiraxame	[副]
samdambi	[不及]
samha	[名]
samina	[数]
sampa	[名]
samsibumbi	[及]
samsimbi	[及]
samsin	[名]
samsu	[名]
samsulabumbi	[及]
samsulambi	[不及]
samuri	[数]
sanat	[名]
sanca	[名]
sancaha	[名]
sancara	[形]
sanciha	[名]
sandalabumbi	[及]
sandalambi	[及]
sandarxambi	[不及]
sanggv	[名]
sanggvxabumbi	[不及]
sanggvxambi	[及]
sangga	[名]
sanggala	[名]
sanggata	[形]
sanggatacambi	[不及]
sanggatanambi	[不及]
sanggatangga	[形]
sangguhe	[名]
sangguji	[名]
sangsarabumbi	[及]
sangsarambi	[及]
sangse	[名]
sangselabumbi	[及]
sangselambi	[及]
saniyabumbi	[及]
saniyambi	[及]
saniyan	[名]
saniyangga	[形]
saniyashvn	[形]
sansi	[名]
sar	[状]
sara	[名]
saraxambi	[不及]
saraxan	[名]
sarabumbi	[及]
saraca	[名]
saraci	[名]
sarahvn	[名]
sarambi	[及]
sarasu	[名]
saratai	[名]
sarba	[名]
sarbaxambi	[及]
sarbacan	[名]
sarbahvn	[形]
sarbatala	[副]
sarca	[名]
sarfu	[名]
sarga	[名]
sargaxambi	[不及]
sargaji	[名]
sargan	[名]
sargiya	[名]
sargiyakan	[形]
sargiyalakv	[名]
sargiyan	[形]
sarhv	[名]
sarhvn	[名]
sarilabumbi	[及][不及]
sarin	[名]
saringgiyambi	[及]
sarki	[名]
sarkiyabumbi	[及]
sarkiyambi	[及]
sarkiyan	[名]
sarkiyangga	[形]
sarkiyanumbi	[及]
sarla	[名]
sarluk	[名]
sarni	[名]
sarpa	[名]
sarsen	[名]
sarta	[名]
sartabumbi	[及]
sartabun	[名]
sartacun	[名]
sartahvn	[名]
sartambi	[及]
sartashvn	[形]
sarwasdi	[名]
sasa	[副]
sasambi	[及][不及]
sasari	[副]
sase	[名]
sasulin	[名]
sasumbi	[不及]
sasuri	[名]
sata	[名]
satangga	[名]
sati	[名]
saya	[名]
se	[名]
seb sab	[状]
sebcelembi	[及]
sebdembi	[不及]
sebden	[名]
sebderi	[名]
sebderibumbi	[及]
sebderilebumbi	[不及]
sebderileku	[名]
sebderilembi	[不及]
sebe saba	[状]
seberxembi	[不及]
seberi	[名]
sebimbi	[不及]
sebjelebumbi	[及]
sebjelembi	[及]
sebjelendumbi	[不及]
sebjelenumbi	[不及]
sebjen	[名]
sebjengge	[形]
sebkelembi	[及]
sebkembi	[及]
sebken	[副]
sebkimbi	[及]
sebsehe	[名]
sebseheri	[名]
sebsibumbi	[不及]
sebsihiyan	[形]
sebsimbi	[不及]
sebsingge	[形]
sec	[名]
secen	[名]
seci	[连]
secibe	[连]
secibumbi	[及]
secimbi	[及]
secindumbi	[及]
secinumbi	[及]
secirembi	[及]
sedehengge	[名]
sedeheri	[形]
sedembi	[及]
sedu	[名]
sefere	[名]
seferexembi	[及]
sefu	[名]
sehehvn	[形]
sehehuri	[形]
sehei	[连]
seherxembi	[不及]
sehercembi	[不及]
seherembi	[不及]
seheri	[形]
sehuji	[数]
sehulembi	[不及]
seibeni	[名]
seilebumbi	[及]
seilembi	[及]
seingge	[形]
seire	[名]
sejeci	[名]
sejen	[名]
sejesi	[名]
sejilembi	[不及]
sejilendumbi	[不及]
sejilenumbi	[不及]
sejulen	[名]
sek	[状]
seke	[名]
sekejembi	[及]
sekembi	[及]
sekiyebumbi	[及]
sekiyeku	[名]
sekiyembi	[及]
sekiyen	[名]
sekji	[名]
sekjingga	[形]
sekse saksa	[形]
seksehe	[名]
seksehun	[形]
seksen	[名]
sekserxembi	[不及]
sekseri	[形]
seksu	[名]
sektebumbi	[及]
sektefun	[名]
sektembi	[及]
sektu	[形]
sektuken	[形]
sektusi	[形]
selabmnbi	[及]
selabun	[名]
selambi	[及]
selbi	[名]
selbibumbi	[及]
selbimbi	[及]
selbin	[名]
sele	[名]
selekje	[名]
selekten	[名]
seleme	[名]
selengge	[形]
selfen	[名]
selgiyebumbi	[及]
selgiyembi	[及]
selgiyen	[名]
selgiyesi	[名]
selhe	[名]
selhen	[名]
selmi	[名]
selmiyen	[名]
sembi	[及]
seme	[连]
semehuken	[形]
semehun	[形]
semejen	[名]
semembi	[不及]
semeo	[小]
semerhen	[名][副]
semibumbi	[及]
semiku	[名]
semimbi	[及]
semken	[名]
semkimbi	[不及]
semnio	[名]
semsu	[名]
sen	[名]
sence	[名]
sencehe	[名]
senceheleku	[名]
sencetu	[名]
senciku	[名]
sendehen	[名]
sendejembi	[及]
sendelebumbi	[及]
sendelembi	[及]
senembi	[及]
seng	[名]
sengge	[形][名]
senggele	[名]
senggelembi	[不及]
senggelengge	[形]
senggete	[名]
senggetu	[名]
senggi	[名]
senggihvn	[形]
senggileme	[及]
senggimbi	[不及]
senggiri	[形]
senggule	[名]
sengguwebumbi	[及]
sengguwecembi	[不及]
sengguwecuke	[形]
sengguwembi	[不及]
sengguwendumbi	[不及]
sengguwenumbi	[不及]
sengken	[名]
sengkiri	[名]
sengkule	[名]
sengse	[名]
sengse saksa	[形]
sengsebumbi	[及]
sengsehun	[形]
sengsembi	[不及]
sengserxembi	[不及]
sengserebumbi	[及]
sengserembi	[不及]
sengsu	[名]
senihun	[形]
senji	[名]
sentehe	[名]
seolebumbi	[不及]
seoleku	[名]
seolembi	[及]
seolen	[名]
seoltei	[名]
ser	[状]
sere	[名]
serebe	[形]
serebumbi	[及]
serebun	[名]
serecun	[名]
serecungge	[形]
serehun	[形]
seremxebumbi	[及]
seremxembi	[及]
serembi	[及]
sereme	[名]
seren sarban	[状]
serengge	[小]
sererembi	[及]
serge	[形]
serguwexebumbi	[及]
serguwexembi	[不及]
serguwen	[形]
seri	[形]
seriken	[形]
serki	[名]
serkin	[名]
serkingge	[形]
serkuwen	[形]
sersen	[状]
seruken	[形]
sese	[名]
sese sasa	[状]
sesembi	[状]
seseme	[副]
sesengge	[形]
seseri	[形]
seshe	[形]
seshebumbi	[及]
seshecuke	[形]
seshembi	[及]
sesheri	[形]
seshetebumbi	[及]
seshetembi	[不及]
seshun	[形]
sesi	[名]
sesilembi	[不及]
sesiri	[名]
sesukiyembi	[不及]
sesuku	[名]
sesulabumbi	[及]
sesulambi	[不及]
sesulembi	[不及]
seterinembi	[及]
seyecuke	[形]
seyecun	[名]
seyembi	[不及]
seyendumbi	[不及]
seyenumbi	[不及]
si	[代][名]
sixa	[名]
sixambi	[不及]
sixanambi	[及]
sixantumbi	[不及]
sixargan	[名]
sixari	[名]
sibxa	[副]
sibxalambi	[及]
sibcambi	[及]
sibe	[名]
sibedembi	[名]
sibehe	[名]
siberebumbi	[及]
siberembi	[及]
siberhen	[名]
siberi	[名]
sibixambi	[及][不及]
sibibumbi	[及]
sibida	[形]
sibirgan	[名]
sibiya	[名]
sibiyalakv	[名]
sibiyalambi	[及]
sibkvri	[名]
sibkari	[形]
sibke	[名]
sibkelebumbi	[及]
sibkelembi	[及]
sibkibumbi	[及]
sibkimbi	[及]
sibshvn	[形]
sibsihvn	[形]
sibsika	[名]
sibsikalambi	[及]
sibumbi	[及]
sicambi	[及]
sidahiyambi	[及]
sidamimbi	[及]
sidan	[名]
sidarabumbi	[及]
sidarambi	[及]
sidarambumbi	[及]
sidehulembi	[及]
sidehun	[名]
sidehunjembi	[及]
siden	[名][方]
sidengge	[形]
siderebumbi	[及]
sidereku	[名]
siderembi	[及]
sidereshvn	[形]
sideri	[名]
siderilengge	[形]
sidu	[形]
sidumbi	[及]
sifa	[形]
sifibumbi	[及]
sifikv	[名]
sifimbi	[及]
sifu fulana ilha	[名]
sifulu	[名]
sigabumbi	[及]
sigambi	[不及]
sigan	[名]
sihakv	[名]
sihali	[名]
sihambi	[及][不及]
sihan	[名]
sihexembi	[及]
sihelembi	[及]
siheri	[形]
sihete	[形]
sihimbi	[及][不及]
sihin	[名]
sihingga	[形]
sihiya	[名]
sihiyakv	[名]
sihiyan	[名]
sija	[名]
sijabumbi	[及]
sijigiyan	[名]
sijihvn	[形]
sijimbi	[及]
sijin	[名]
sijirhvn	[形]
sikv	[名]
sika	[名]
sikari	[名]
sike	[名]
sikse	[名]
sikseri	[名]
siktan	[名]
silan	[名]
silba	[名]
silda	[名]
sile	[名]
silehen	[名]
silemidembi	[不及]
silemin	[形]
silemtu	[名]
silenggi	[名]
silenggixembi	[及]
silenggimbi	[及]
silenginembi	[及]
silgabun	[名]
silgambi	[及]
silgasi	[名]
silgimbi	[及]
silgiyabumbi	[及]
silgiyambi	[及]
silhata	[名]
silhi	[名]
silhidabumbi	[不及]
silhidambi	[及]
silihi	[名]
silimbi	[及]
silin	[形]
siliyan	[名]
silja	[名]
silkabumbi	[不及]
silkada	[形]
silkan	[形][名]
silkari	[形]
silmelembi	[及]
silmen	[名]
silmengge	[形]
siltambi	[及]
siltan	[名]
silun	[名]
simacuka	[形]
simacukangge	[名]
simari	[形]
simatun	[名]
simbi	[及]
simcan	[名]
simebumbi	[及]
simelen	[名]
simeli	[形]
simelje	[名]
simembi	[及]
simen	[名]
simengge	[形]
simenggi	[名]
simenggilebumbi	[及]
simenggilembi	[及]
simhulembi	[不及]
simhun	[名]
simhuri	[名]
simikte	[名]
simimbi	[及]
simiyan	[名]
simnembi	[及]
simnen	[名]
simnendumbi	[及]
simnenembi	[及]
simnenjimbi	[及]
simnenumbi	[及]
simnesi	[名]
simori	[名]
simten	[形]
simtu	[名]
simun	[名]
sin	[名]
sinagalambi	[不及]
sinagan	[名]
sinahi	[名]
sinahilambi	[及]
sindambi	[及]
sindu	[名]
sindubi	[名]
singgexu	[名]
singgebumbi	[及]
singgehvn	[名]
singgeku	[名]
singgembi	[及]
singgeri	[名]
singgeringge	[名]
singgetei	[副]
singgetu	[名]
singgirambi	[及]
singgiyambi	[及]
singkeyen	[形]
singsilembi	[及]
siningge	[名]
siojan	[名]
siolembi	[及]
siowan	[名]
siowan dzung	[名]
sir	[状]
sira	[名]
sirabumbi	[及]
sirabungga	[名]
siraca	[名]
sirakv	[名]
sirambi	[及]
sirame	[形]
siramengge	[形]
siran	[名]
sirandumbi	[不及]
sirasha	[名]
sirata	[名]
sirbaxambi	[及]
sirbe	[名]
sirdan	[名]
sirdangga	[形]
sirebumbi	[及]
sirebun	[名]
sirecu	[名]
sirembi	[及]
siremi	[名]
siren	[名]
sirendumbi	[及]
sirenembi	[不及]
sirenen	[名]
sirengge	[形]
sirentu	[名]
sirentumbi	[及]
sirentusi	[名]
siresi	[名]
sirgahvn	[名]
sirgan	[名]
sirgatu	[名]
sirge	[名]
sirgelembi	[及]
sirgengge	[形]
sirgeri	[名]
sirgetu	[名]
sirha	[名]
sirhacin	[名]
siri	[名]
siribumbi	[及]
sirilembi	[及]
sirimbi	[及]
sirin	[名]
sirke	[形]
sirkedembi	[不及]
sirsi	[名]
sirsing	[名]
sisa	[名]
sisabumbi	[及]
sisambi	[不及]
sisebumbi	[及]
sisehen	[名]
siseku	[名]
sisembi	[及]
sisetembi	[及]
sishe	[名]
sisi	[名]
sisi xaxa	[状]
sisiku	[形]
sisimbi	[及]
sisin	[名]
sisingga	[形]
sisirengge	[名]
sisiri	[名]
sisuhu	[名]
sita	[叹][名]
sitabumbi	[及]
sitahvn	[形]
sitambi	[不及]
sitashvn	[形]
siteku	[名]
sithvmbi	[不及]
sithen	[名]
situmbi	[不及]
siyvn fu	[名]
siyan	[名]
siyan lo	[名]
siyan wa Kaya	[名]
siyanceo	[名]
siyoo	[名]
siyoo jiyei	[名]
siyooxun	[名]
sko	[名]
slagangga	[形]
so	[名]
sobonio	[名]
sobori	[名]
soboro	[名]
soca	[名]
socili	[形]
soco	[名]
sodzy	[名]
sofen	[名]
sofidambi	[不及]
sofin	[形]
sofintu	[名]
soforo	[名]
soforombi	[及]
sogi	[名]
sogiya	[名]
sohin	[形][名]
soho	[名]
sohoci	[名]
sohoco	[名]
sohohvri	[形]
sohohori	[形]
sohokoliyan	[形]
sohokon	[形]
sohon	[形]
soihen	[名]
soiho	[名]
soikara weijun	[名]
soilo	[名]
soilombi	[及]
soison	[名]
sokxolimbi	[及]
sokji	[名]
soko	[名]
soksimbi	[不及]
sokso saksa	[状]
soksohon	[形]
soksohori	[形]
soksori	[副]
soktobumbi	[及]
soktokv	[名]
soktombi	[及]
soktotolo	[副]
solambi	[及]
solbimbi	[及]
solha	[名]
solho	[形][名]
solimbi	[及]
solin	[形]
solinabumbi	[及]
solinambi	[及]
solinjimbi	[及]
solmin	[名]
solo	[名]
solohi	[名]
solombi	[及]
solon	[名]
sombi	[及]
somimbi	[及]
somina	[名]
somindumbi	[及]
sominumbi	[及]
somishvn	[名]
somitambi	[不及]
somnio	[名]
somo	[名]
son	[名]
son son	[形]
sonambi	[不及]
soncoho	[名]
songgiha	[名]
songgina	[名]
songgobumbi	[及]
songgocombi	[不及]
songgombi	[及]
songgotu	[形]
songko	[名]
songkoi	[后]
songkolobumbi	[及]
songkolombi	[及]
songkolorongge	[名]
sonihon	[名]
soningga	[名]
sonio	[名]
sonjobumbi	[及]
sonjoku	[形]
sonjombi	[及]
sonjondumbi	[及]
sonjonumbi	[及]
sonjosi	[名]
sonokton	[名]
sonombi	[及]
sontu	[名]
soorilambi	[及]
soorin	[名]
sor	[状]
sorbo	[名]
sori	[名]
soriganjambi	[不及]
soriha	[名]
sorihalambi	[及]
sorin	[名]
sorko	[名]
soro	[名]
sorobumbi	[及]
sorocombi	[及]
sorocuka	[形]
sorokv	[名]
soroki	[名]
sorokiya	[名]
sorombi	[不及]
sorosu	[名]
sorotu	[名]
sorson	[名]
sosambi	[及]
sosandumbi	[及]
sosanumbi	[及]
sosombi	[不及]
sosorcombi	[及]
sosorobumbi	[及]
sosorombi	[及]
sotambi	[及]
soti	[名]
sotki	[名]
soyolji	[名]
soyombi	[不及]
soyon	[名]
soyori	[名]
su	[名]
subadambi	[不及]
subargan	[名]
subarhan	[名]
subari	[名]
subcalu	[形]
sube	[名]
subehe	[名]
subekelebumbi	[及]
subeliyen	[名]
suberhe	[名]
suberi	[名]
subetungge	[名]
subkejembi	[不及]
subkelembi	[及]
subkeri	[及]
subsi	[形]
subsin	[名]
subuhvn	[形]
subuhen	[名]
subumbi	[及]
subun	[名]
suburi	[名]
suci	[名]
sucilembi	[不及]
sucumbi	[及]
sucun	[名]
sucunambi	[及]
sucungga	[名]
sucunjimbi	[及]
sucutu	[名]
sudala	[名]
sudalabumbi	[及]
sudalambi	[及]
sudan	[名]
suderhen	[名]
sudu	[名]
suduli	[名]
sudunggiyambi	[及]
suduntu	[名]
suduri	[名]
sufan	[名]
sufen	[名]
suhai	[名]
suharambi	[不及]
suhe	[名]
suhexembi	[及]
suhecen	[名]
suhelembi	[及]
suhen	[名]
suhuken	[形]
suhun	[形]
sui	[名]
sui cecike	[名]
sui gung	[名]
suibumbi	[及]
suifulebumbi	[及]
suifulembi	[及]
suifun	[名]
suiha	[名]
suihana	[名]
suihe	[名]
suihenembi	[不及]
suihetu	[名]
suihon	[名]
suihumbi	[不及]
suihun	[名]
suihutu	[名]
suilabumbi	[及]
suilacuka	[形]
suilacun	[名]
suilambi	[及]
suilan	[名]
suilashvn	[形]
suimangga	[形]
suimbi	[及]
suingga	[名]
suisimbi	[及]
suisiru	[形]
suitabumbi	[及]
suitakv	[名]
suitambi	[及]
sujabumbi	[及]
sujahan	[名]
sujakv	[名]
sujambi	[及]
sujanambi	[不及]
suje	[名]
sujikde	[名]
sujubumbi	[及]
sujumbi	[不及]
sujutembi	[不及]
suk	[状]
sukv	[名]
sukvnambi	[及]
sukvngge	[形]
sukden	[名]
sukduhen	[名]
sukdun	[名]
sukiyabumbi	[及]
sukiyambi	[及]
sukiyangga	[形]
sukji	[名]
sukjibumbi	[及]
sukjimbi	[及]
sukjingge	[形]
suksaha	[名]
suksalabumbi	[及]
suksalambi	[及]
suksalanambi	[及]
suksalandumbi	[及]
suksalanjimbi	[及]
suksalanumbi	[及]
suksan	[名]
suksubumbi	[及]
suksuhu	[名]
suksuhun	[形]
suksumbi	[及]
suksurebumbi	[及]
suksureku	[名]
suksurembi	[及]
suku	[名]
sula	[形]
sulabumbi	[及]
sulahvn	[名]
sulakan	[形]
sulambi	[及]
suldargan	[名]
sulfa	[形]
sulfakan	[形]
sulfambi	[不及]
sulfangga	[形]
sulhumbi	[不及]
sulku	[名]
sultaha	[名]
sultei	[名]
sultungga	[名]
sumaga	[名]
sumala	[名]
sumaltu	[名]
sumambi	[不及]
suman	[名]
sumarhan	[名]
sumari	[名]
sumbi	[及][不及]
sumbuljambi	[不及]
sumbur	[状]
sumburxambi	[不及]
sumiri	[名]
sumpa	[形][名]
sumpanambi	[不及]
sumusu	[名]
sun	[名]
suncehen	[名]
sundalabumbi	[及]
sundalambi	[及]
sundalanjimbi	[及]
sunembi	[不及]
sung el	[名]
sunggada	[名]
sunggali	[名]
sunggari	[名]
sunggartu	[名]
sunggeljebumbi	[及]
sunggeljembi	[不及]
sunggelson	[名]
sunggembi	[不及]
sunggina	[名]
sunggiyen	[形]
sungguhe	[名]
sunja	[数]
sunjaci	[数]
sunjangga	[名]
sunjanggeri	[数]
sunjari	[名]
sunjata	[数]
sunji	[名]
sunta	[名]
suntaha	[名]
suntanambi	[不及]
suntebumbi	[及]
suntembi	[及]
sunto	[名]
sur	[状]
surabumbi	[及][不及]
surafu	[名]
suraku	[名]
surambi	[及][不及]
suran	[名]
surbejen	[名]
surbu	[名]
sureken	[形]
surembi	[不及]
surgi	[名]
surgin	[形]
surhvn	[形]
suri	[名]
surimbi	[不及]
sursen	[名]
surseri	[名]
surtembi	[不及]
surtendumbi	[不及]
surtenumbi	[不及]
suru	[名]
surudai	[名]
suruk	[名]
surumbi	[及]
surumbumbi	[及]
susai	[数]
susaici	[数]
susaita	[数]
susakangge	[名]
susambi	[及]
suse	[名]
susedembi	[不及]
suseri	[形][名]
susu	[名]
susubumbi	[及]
susukiyembi	[及]
susultungga	[名]
susumbi	[及]
susunggiyabumbi	[及]
susunggiyambi	[及]
sutuhvn	[名]
suwa	[名]
suwabirgan	[名]
suwafintu	[名]
suwakidun	[名]
suwalin	[名]
suwaliyabumbi	[及]
suwaliyaganjambi	[及]
suwaliyambi	[及]
suwaliyan	[形]
suwaliyasun	[名]
suwaliyata	[形]
suwan	[名]
suwanda	[名]
suwandara	[名]
suwangkiyabumbi	[及]
suwangkiyambi	[及]
suwangkiyandumbi	[及]
suwasha	[名]
suwayakan	[形]
suwayan	[形]
suwe	[代]
suwelebumbi	[及]
suwelembi	[及]
suwelenembi	[及]
suwelenjimbi	[及]
suya	[名]
suyambi	[及]
suyamu	[名]
suyen	[名]
sy	[名]
sycuwan	[名]
tvbumbi	[及]
tvku	[名]
tvmbi	[及]
ta	[状]
taxan	[形]
taxarabumbi	[及]
taxarambi	[不及]
tabarambi	[不及]
tabcilabumbi	[不及]
tabcilambi	[及]
tabcilanambi	[及]
tabcilandumbi	[及]
tabcilanjimbi	[及]
tabcilanumbi	[及]
tabcin	[名]
tabsitambi	[不及]
tabtaxambi	[及]
tabuxambi	[及]
tabukv	[名]
tabumbi	[及]
tabunang	[名]
taburi	[名]
tabusitambi	[不及]
tacibuhangge	[名]
tacibukv	[名]
tacibumbi	[及]
tacihangge	[名]
tacihiyakv	[名]
tacihiyambi	[及]
tacihiyan	[名]
tacikv	[名]
tacimbi	[及]
tacimsi	[名]
tacin	[名]
tacinambi	[及]
tacindumbi	[及]
tacinjimbi	[及]
tacinumbi	[及]
tacinun	[名]
tadurambi	[及]
tafabumbi	[及]
tafambi	[及]
tafambumbi	[及]
tafanambi	[及]
tafandumbi	[及]
tafanjimbi	[及]
tafanumbi	[及]
tafitu	[名]
tafu	[名]
tafuxambi	[及]
tafukv	[名]
tafulambi	[及]
tafulan	[名]
tafumbi	[及]
tagiri	[名]
tahvra	[名]
tahvrangga	[形]
tahalabumbi	[及]
tahalambi	[及]
tahan	[名]
tahi	[名]
tai	[名]
tai giya	[名]
tai ho coko	[名]
taixeo	[名]
taixi	[名]
taiboo	[名]
taibu	[名]
taidzu	[名]
taidzung	[名]
taidzy	[名]
taifin	[名]
taifingga	[形]
taifintu	[名]
taifu	[名]
taigiyan	[名]
taihvwa	[名]
taiha	[名]
taiheo	[名]
taijingga	[形]
tailahi	[名]
taili	[名]
taimin	[名]
taimiyoo	[名]
taimpa	[名]
taimpari	[形]
tairan	[名]
taisui	[名]
taiyvn	[名]
taji	[名]
tajirambi	[不及]
tak	[状]
takv	[名]
takvlu	[副]
takvrxabumbi	[不及]
takvrxambi	[及]
takvrakv	[名]
takvrambi	[及]
takvran	[名]
takvrandumbi	[及]
takvrsi	[名]
taka	[副]
takambi	[及][不及]
takan	[名]
takanambi	[及]
takandumbi	[及]
takanjimbi	[及]
takanumbi	[及]
takciha	[名]
takdambi	[不及]
takdangga	[名]
takintu	[名]
takitu	[名]
takiya	[名]
taksiburakv	[名]
taksimbi	[及]
takta	[名]
taktan	[名]
taktu	[名]
tala	[名]
talabumbi	[及]
talambi	[及]
talbi	[名]
talbu	[名]
talfa	[名]
talfari	[名]
talgan	[名]
talgari	[名]
talgibumbi	[及]
talgikv	[名]
talgimbi	[及]
talgiyan	[名]
talixambi	[不及]
talihvn	[形]
talihvnjambi	[不及]
talkambi	[及]
talkiyambi	[不及]
talkiyan	[名]
talmahan	[名]
talmambi	[不及]
talman	[名]
taltan	[名]
talu	[形][名]
talude	[连]
tama	[名]
tamabumbi	[及]
tamalimbi	[及]
tamambi	[及]
taman	[名]
tambi	[及]
tamixambi	[及]
tamin	[名]
tampin	[名]
tamse	[名]
tamtan	[名]
tamun	[名]
tan	[名]
tana	[名]
tanangga	[形]
tang	[名][状]
tanggv	[数]
tanggvci	[数]
tanggvha	[名]
tanggvli	[名]
tanggvnggeri	[数]
tanggvri	[形]
tanggvt	[名]
tanggvte	[数]
tanggambi	[及]
tanggibumbi	[及]
tanggikv	[名]
tanggilakv	[名]
tanggilambi	[及]
tanggimbi	[及]
tanggimeliyan	[形]
tanggin	[名]
tanggingge	[形]
tanggiri	[名]
tanggiyabumbi	[及]
tanggiyambi	[及]
tangkambi	[及]
tangkan	[名]
tangki	[名]
tangse	[名]
tangsika	[名]
tangsimbi	[及]
tangsime	[副]
tangsu	[形]
tangsulambi	[及]
tangwan	[名]
tani	[名]
tanjambi	[及]
tanji	[名]
tanjurambi	[不及]
tantabumbi	[及][不及]
tantambi	[及]
tantanumbi	[及]
tantu	[名]
tar	[状]
tara	[名]
taracin	[名]
taran	[名]
tarbahi	[名]
tarbalji	[名]
tarcan	[名]
targa	[名]
targabun	[名]
targacun	[名]
targambi	[及]
targan	[名]
targangga	[形]
targikv	[名]
tarhvkan	[形]
tarhvlambi	[不及]
tarhvmbi	[不及]
tarhvn	[形][名]
taribumbi	[及]
tarimbi	[及]
tarinambi	[及]
tarinjimbi	[及]
tarinumbi	[及]
tarmin	[名]
tarni	[名]
tarnilambi	[及]
tarsi	[名]
tarsilambi	[不及]
tarudambi	[及]
tarun	[名]
tas	[状]
tasgabumbi	[及]
tasgambi	[及]
tashv	[名]
tashvmbi	[不及]
tasha	[名]
tashaci	[名]
tashambi	[及]
tashari	[名]
tasihvn	[名]
tasihimbi	[及]
tasima	[名]
tasma	[名]
tataxambi	[不及]
tatakv	[名]
tatala	[副]
tatambi	[及]
tatan	[名]
tatanambi	[及]
tatandumbi	[及]
tatangga	[形]
tatanjimbi	[及]
tatanumbi	[及]
tatarabumbi	[及]
tatarambi	[及]
tathvnjacuka	[形]
tathvnjambi	[及]
tatuhan	[名]
tayambi	[不及]
tayungga	[形]
te	[名]
tebcimbi	[及]
tebeliyebumbi	[及]
tebeliyeku	[名]
tebeliyembi	[及]
tebeliyen	[名]
teben	[名]
tebke	[名]
tebke tabka	[状]
tebkejembi	[及]
tebkelembi	[及]
tebku	[名]
tebsehe	[名]
tebubumbi	[及]
tebumbi	[及]
tebunebumbi	[及]
tebunembi	[不及]
tebunumbi	[及]
teburelambi	[及]
tecebumbi	[及]
tecembi	[不及]
tecendumbi	[不及]
tecenumbi	[不及]
tede	[副]
tefembi	[不及]
tehe	[名]
tehen	[名]
teherxembi	[及]
teherebubumbi	[及]
teherebuku	[名]
teherebumbi	[及]
teherembi	[不及]
tehereme	[后]
teheren	[名]
teherendumbi	[及]
teixun	[名]
teifuxembi	[及]
teifun	[名]
teifungge	[名]
teike	[副]
teile	[后][副]
teile akv	[连]
teisu	[名][方]
teisu teisu	[副]
teisulebumbi	[不及]
teisulembi	[及]
teisulen	[名]
teisungge	[形]
teisutu	[名]
tejihen	[名]
tek tak	[状]
tekdebumbi	[及]
tekdembi	[不及]
tekembi	[不及]
teksiken	[形]
teksilebumbi	[及]
teksilembi	[及]
teksilen	[名]
teksilgan	[名]
teksin	[形][名]
teksingge	[形]
teku	[名]
telambi	[不及]
telejembi	[及]
telejen	[形][名]
telembi	[及]
teleri	[名]
telgin	[名]
teliyebumbi	[及]
teliyeku	[名]
teliyembi	[及]
temxebumbi	[及]
temxembi	[及]
temxen	[名]
temxendumbi	[及]
temxenumbi	[及]
tembi	[不及]
temciku	[名]
temege	[名]
temen	[名]
temene ulhe	[名]
temenembi	[不及]
temeri	[形]
temgetu	[名]
temgetulehe	[名]
temgetulembi	[及]
temgetun	[名]
temgetungge	[形]
temimbi	[及]
tempin	[名]
temuhen	[名]
temun	[名]
temurtu	[形]
ten	[名]
tenembi	[及]
teng	[状]
tenggeljeku	[名]
tenggeljembi	[及]
tenggeri	[名]
tenggin	[名]
tengki tangki	[状]
tengkibumbi	[及]
tengkicuke	[形]
tengkimbi	[及]
tengneku	[名]
tengnembi	[及]
tengse	[名]
tengtembi	[及]
teni	[副]
teniken	[副]
tenjimbi	[及]
tenju	[名]
tenteke	[代]
tentekengge	[名]
tenumbi	[及]
teo too	[名]
teodebumbi	[及]
teodembi	[及]
teodenjembi	[及]
ter	[状]
terbun	[数]
tere	[代]
tere anggala	[连]
tere dade	[连]
tereci	[连]
tereingge	[名]
tereni	[副]
tergeci	[名]
tergimbi	[及]
tergin targin	[形]
terkimbi	[及]
terkin	[名]
terme lorin	[名]
terten tartan	[形]
teru	[名]
tes	[状]
teseingge	[名]
tesu	[名]
tesubumbi	[及]
tesumbi	[及]
tesun	[名]
tete tata	[形]
tetele	[副]
tetendere	[连]
tetuxembi	[及]
tetun	[名]
teyebumbi	[及]
teyehun	[名]
teyembi	[及]
teyen	[名]
teyenderakv	[不及]
teyendumbi	[不及]
teyenembi	[不及]
teyenjimbi	[不及]
teyenumbi	[不及]
tinggin	[名]
tinggu cecike	[名]
tingguri cecike	[名]
tingse	[名]
tirdargan	[名]
tirhvtan	[名]
tiyelin	[名]
tiyeliyen	[名]
to	[名]
to gi	[名]
tob	[名][状]
tobcalambi	[及]
tobcomggo	[形]
tobgiya	[名]
tobo	[名]
tobtelembi	[及]
tobtiyalambi	[及]
tobtoko	[名]
todo	[名]
todolo	[名]
tofohoci	[数]
tofohon	[数]
tofohonggeri	[数]
tofohoto	[名][数]
togiya	[名]
tohixambi	[及]
tohin	[名]
toho	[名]
tohobumbi	[及]
toholiyo	[名]
toholon	[名]
tohoma	[名]
tohombi	[及]
tohomimbi	[及]
tohon	[名]
tohoro	[名]
tohorokv	[名]
tohorombi	[不及]
tohorombumbi	[及]
toilokoxombi	[及]
toiton	[名]
toitonggo	[名]
tojangga	[名]
tojin	[名]
tojingga	[形]
tok	[状]
tokai	[名]
tokdon	[名]
tokoxombi	[及]
tokombi	[及]
toksikv	[名]
toksimbi	[及]
toksin	[名]
toksitu	[名]
tokso	[名]
toksorombi	[不及]
toktoba	[名]
toktobumbi	[及]
toktohon	[名]
toktombi	[及]
tokton	[名]
toktonombi	[及]
toktontu	[名]
tolbotu	[名]
toldohon	[名]
tolgixambi	[不及]
tolgimbi	[不及]
tolgin	[名]
tolholombi	[及]
tolhon	[名]
toli	[名]
tolobumbi	[及]
tolombi	[及]
tolon	[名]
tome	[后]
tomika	[名]
tomilambi	[及]
tomilandumbi	[及]
tomobumbi	[及]
tomoho	[名]
tomohonggo	[名]
tomombi	[及]
tomon	[名]
tomoo	[名]
tomorhan	[名]
tomorhon	[形]
tomoro	[名]
tomoron	[名]
tomortai	[形]
tomotu	[名]
tomsobumbi	[及]
tomsombi	[及]
ton	[名]
tondo	[名]
tondokon	[形]
tondolombi	[不及]
tondongge	[形]
tong	[状]
tonggvlimbi	[及]
tongga	[形]
tonggalu	[名]
tonggime	[副]
tonggo	[名]
tonggolibumbi	[及]
tonggolikv	[名]
tonggolimbi	[及]
tongki	[名]
tongkixakv	[名]
tongkixambi	[及]
tongkimbi	[及]
tongkin	[名]
tongsimbi	[及]
tongsirambi	[及]
tonikv	[名]
tonio	[名]
tonjimbi	[及]
tono	[名]
tontu	[名]
toodabumbi	[及]
toodambi	[及]
toohan	[名]
toohanjambi	[及]
tookabumbi	[不及]
tookambi	[及]
tookan	[名]
tookanjambi	[不及]
toombi	[及]
toonumbi	[及]
toorin	[名]
toose	[名]
tooselambi	[及]
toosengge	[形]
tor	[状]
torgikv	[名]
torgimbi	[及]
torhikv	[名]
torho cecie	[名]
torhombi	[及]
torhon	[名]
toribuhangge	[名]
toribumbbi	[及]
torimbi	[及]
toro	[名]
toroci	[名]
torombi	[不及]
torombumbi	[及]
toron	[名]
tos	[状]
tosi	[名]
tosobumbi	[及]
tosombi	[及]
tot	[名]
totan	[名]
toyon	[名]
toyonggo	[形]
tu	[名]
tu mei ilha	[名]
tu nio furgi	[名]
tuxahv	[名]
tuxambi	[及]
tuxan	[名]
tuxangga	[形]
tuxanjimbi	[及]
tuxnambi	[及]
tuba	[代]
tubaingge	[形]
tubehe	[名]
tubet	[名]
tubi	[名][数]
tubixembi	[及]
tubihe	[名]
tubilembi	[及]
tubingga	[名]
tubitu	[名]
tucibumbi	[及]
tucibun	[名]
tucibunumbi	[及]
tucimbi	[及]
tucin	[名]
tucindembi	[不及]
tucine	[名]
tucinembi	[不及]
tucinjimbi	[不及]
tufulembi	[及]
tufun	[名]
tugi	[名]
tugidei	[名]
tugingga omolo	[名]
tugingge	[形]
tugiri	[名]
tugitu	[名]
tugitun	[名]
tuhaxambi	[及]
tuhan	[名]
tuhe	[名]
tuhebuku	[名]
tuhebumbi	[及]
tuhebun	[名]
tuhembi	[不及]
tuhembumbi	[及]
tuhen	[名]
tuhenembi	[不及]
tuhenjimbi	[不及]
tuhere	[名]
tuheri	[形]
tuhete	[形]
tuibalabumbi	[及]
tuibalakv	[名]
tuibalambi	[及]
tuibin	[名]
tuibumbi	[名]
tuilambi	[不及]
tuilebumbi	[及]
tuilembi	[及]
tuilendumbi	[及]
tuilenumbi	[及]
tuk tuk	[状]
tukxan	[及]
tukda	[名]
tukden	[名]
tukiya	[名]
tukiyeceku	[形]
tukiyecembi	[及]
tukiyecun	[名]
tukiyeku	[名]
tukiyelembi	[及]
tukiyembi	[及]
tukiyen	[名]
tukiyeri	[形]
tukiyeshvn	[形]
tukiyesi	[名]
tuksa	[名]
tuksaka	[名]
tuksicuke	[形]
tuksimbi	[不及]
tuksintu	[名]
tuksitebumbi	[及]
tuksitembi	[不及]
tuktan	[名]
tuktarhan	[名]
tuktuma	[名]
tuku	[名]
tukulembi	[及]
tulbimbi	[及]
tule	[方]
tulebumbi	[及]
tulejehembi	[及]
tulembi	[及][不及]
tulergi	[方]
tulergingge	[名]
tuleri	[方]
tulesi	[方]
tulgiri	[名]
tulgiyen	[形][后]
tulhu	[名]
tulhuxembi	[不及]
tulhun	[形]
tulibumbi	[及]
tulimbi	[不及]
tulin	[名]
tulu	[名]
tuluma	[名]
tulume	[名]
tumehe	[名]
tumen	[名][数]
tumenci	[数]
tumene	[名]
tumengge	[名]
tumenggeri	[数]
tumete	[数]
tumgetu	[名]
tumgi	[名]
tumiha	[名]
tumikan	[形]
tumin	[形]
tumpanambi	[不及]
tumsoro	[名]
tun	[名]
tung	[状]
tung furdan	[名]
tung guwan	[名]
tunggalambi	[及]
tunggen	[名]
tunggi	[名]
tunggiyebumbi	[及]
tunggiyembi	[及]
tunggu	[名]
tunggulembi	[及]
tungio	[名]
tungjeo	[名]
tungken	[名]
tungkeri	[名]
tungki	[状]
tungku	[副]
tunglu	[形]
tungnibumbi	[及]
tungse	[名]
tungserebumbi	[及]
tungserembi	[及]
tungsika gurgu	[名]
tungsitun	[名]
tungtung tangtang	[状]
tuniyeltu	[形]
tuniyembi	[及]
tunuhv	[名]
tur	[状]
turxul	[名]
turxun	[名]
tura	[名]
turabumbi	[及]
turakv	[名]
turaki	[名]
turambi	[及]
turbelji	[名]
ture	[名]
turemimbi	[及]
turfan	[名]
turgvt	[名]
turga	[形][名]
turga efen	[名]
turgalambi	[不及]
turgatu	[名]
turgen	[形]
turgimbi	[不及]
turgun	[名]
turha	[形][名]
turi	[名]
turibumbi	[及]
turigen	[名]
turimbi	[及]
turitu	[名]
turtun	[名]
turtung	[名]
turu	[名]
turulabumbi	[及]
turulambi	[及]
turun	[名]
turungge	[形]
tus	[状]
tusa	[名]
tusangga	[形]
tusergen	[名]
tushv	[名]
tusihiya	[名]
tusihiyalabumbi	[及]
tusihiyalambi	[及]
tusihiyen	[形]
tusu	[名]
tusumbi	[不及]
tusy	[名]
tutabumbi	[及]
tutala	[代]
tutambi	[及]
tuttu	[代][连]
tuttusi	[代]
tuwa	[名]
tuwaxabumbi	[及]
tuwaxambi	[及]
tuwaxatabumbi	[及]
tuwaxatambi	[及]
tuwabun	[名]
tuwabunambi	[及]
tuwabungga	[名]
tuwakv	[名]
tuwakvn	[名]
tuwakiyabumbi	[及]
tuwakiyambi	[及]
tuwakiyan	[名]
tuwakiyanambi	[及]
tuwakiyandumbi	[及]
tuwakiyanjimbi	[及]
tuwakiyantu	[名]
tuwakiyanumbi	[及]
tuwakiyasi	[名]
tuwambi	[及]
tuwamcin	[名]
tuwamehangge	[形]
tuwamgiyabumbi	[及]
tuwamgiyambi	[及]
tuwanabumbi	[及]
tuwanambi	[及]
tuwancihiyabumbi	[及]
tuwancihiyabun	[名]
tuwancihiyakv	[名]
tuwancihiyambi	[及]
tuwancihiyan	[名]
tuwanggimbi	[及]
tuwanjimbi	[及]
tuwanumbi	[及]
tuwaran	[名]
tuwekiyembi	[及]
tuwelebumbi	[及]
tuwelembi	[及]
tuwelesi	[名]
tuweri	[名]
tuwerikten	[名]
tuwerimu	[名]
tuweturi	[名]
tuyabumbi	[及]
tuyambi	[形]
tuyebumbi	[及]
tuyekte	[名]
tuyeku	[名]
tuyembi	[及]
tuyembubumi	[及]
tuyembumbi	[不及]
u	[名][状]
u xan	[名]
u fo guwan	[名]
u guwan	[名]
u hiya	[名]
u niyehe	[名]
u tung	[名]
uxabun	[名]
uxakv	[名]
uxambi	[及]
uxan faxan	[形]
uxarki	[名]
uxatabumbi	[不及]
uxatambi	[及]
uxe	[形][名]
uxebumbi	[及]
uxei	[名]
uxembi	[及]
uxengge	[形]
uahan	[名]
uai nimaha	[名]
uba	[代]
ubaxabumbi	[及]
ubaxakv	[名]
ubaxatambi	[不及]
ubaingge	[代]
ubaka	[状]
ubaliyambi	[不及]
ubaliyambubumbi	[及]
ubaliyambumbi	[及]
ubaliyan	[名][不及]
ubasitambi	[不及]
ubihiya	[名]
ubise	[名]
ubiyabumbi	[不及]
ubiyabutu	[名]
ubiyacuka	[形]
ubiyacun	[名]
ubiyada	[形]
ubiyambi	[及]
ubiyoo	[名]
ubu	[名]
ubungge	[形]
uca	[名]
ucalambi	[及]
ucarabun	[名]
ucarambi	[及]
ucaran	[名]
uce	[名]
ucika	[名]
ucikalambi	[不及]
ucileh	[名]
ucubumbi	[及]
ucudambi	[不及]
uculebumbi	[及]
uculembi	[及]
uculen	[名]
uculesi	[及]
ucumbi	[及]
ucun	[名]
ucuri	[名]
udabumbi	[及]
udala	[名]
udamabumbi	[及]
udambi	[及]
udanambi	[及]
udanjimbi	[及]
udanumbi	[及]
udaralambi	[及]
udelembi	[不及]
uden	[名]
udu	[数][连]
uduci	[数]
uducingge	[数]
ududu	[数]
udumbara	[名]
udunggeri	[数]
udute	[数]
uduwen	[名]
uege	[名]
ufa	[名]
ufabumbif	[及]
ufambi	[及]
ufarxambi	[不及]
ufarabumbi	[及]
ufaracun	[名]
ufaraki	[名]
ufarambi	[及]
ufaran	[名]
ufarsambi	[不及]
ufibumbi	[及]
ufihi	[名]
ufimbi	[及]
ufin	[名]
ufuhi	[名]
ufuhu	[名]
ufuhunambi	[不及]
ufuhunembi	[不及]
ugingge	[形]
uhv	[名]
uhvbumbi	[不及]
uhvkv	[名]
uhvlja	[名]
uhvma	[形]
uhvmbi	[不及]
uhvyan	[名]
uhala	[名]
uhe	[形]
uhelembi	[不及]
uhelenjimbi	[及]
uhen	[名]
uhereme	[副]
uheri	[形]
uherilembi	[及]
uhesu	[形]
uhuhengge	[名]
uhukedembi	[不及]
uhukeliyan	[形]
uhuken	[形]
uhumbi	[及]
uhume	[名]
uhun	[名]
uhungge	[形]
uhutu	[名]
ui nimaha	[名]
uibo	[名]
uigiyangga	[形]
uihe	[名]
uihengge	[形]
uiherin	[名]
uiheton	[名]
uihetongge	[形]
uihuri haihari	[状]
uilembi	[及]
uilen	[名]
uisngga	[名]
uisuru	[名]
ujan	[名]
ujeken	[形]
ujelembi	[不及]
ujen	[形]
ujibun	[名]
ujima	[名]
ujimbi	[及]
ujin	[名]
ujinambi	[及]
ujindumbi	[及]
ujinembi	[及]
ujingga	[形]
ujinumbi	[及]
ujirhi	[名]
uju	[名]
ujuci	[数]
ujukv	[名]
ujulabumbi	[及]
ujulambi	[不及]
ujungga	[形]
ujungge	[名]
ukabumbi	[及]
ukacambi	[不及]
ukada	[名]
ukadambi	[不及]
ukambi	[不及]
ukambumbi	[及]
ukan	[名]
ukanju	[名]
ukatan	[名]
ukcabumbi	[及]
ukcambi	[不及]
ukdun	[名]
ukeci	[名]
ukecin	[名]
uki	[名]
ukiyaka	[名]
ukiyebumbi	[及]
ukiyembi	[及]
uksa	[副]
uksalabumbi	[不及]
uksalambi	[及]
uksan	[副]
uksen	[名]
uksilebumbi	[及]
uksilembi	[及]
uksilendumbi	[及]
uksilenumbi	[及]
uksin	[名]
uksun	[名]
uksungga	[形]
uksura	[名]
uktu	[形]
uktun	[形]
uku	[名]
ukuhe	[形]
ukuhu	[名]
ukulebumbi	[及]
ukulembi	[及]
ukumbi	[及]
ukundumbi	[及]
ukunjimbi	[及]
ukuri	[名]
ula	[名]
ulabumbi	[及]
ulabun	[名]
ulaci	[名]
uladambi	[不及]
ulahvn	[名]
ulambi	[及]
ulan	[形][名]
ulana	[名]
ulandumbi	[不及]
ulandusi	[名]
ulangga	[形]
ulbimbi	[不及]
ulcen	[名]
ulcilembi	[及]
ulcin	[名]
uldefun	[名]
uldembi	[不及]
ulden	[名]
uldengge	[名]
ulderhen	[名]
uldun	[名]
ule	[名]
ulebubumbi	[及]
ulebumbi	[及]
ulebusi	[名]
ulejebumbi	[及]
ulejembi	[不及]
ulembi	[及]
ulen	[名]
ulenggu	[名]
uleri	[名]
ulgv	[名]
ulga	[名]
ulgabumbi	[及]
ulgakv	[名]
ulgambi	[不及]
ulgan	[形]
ulgimbi	[不及]
ulgiyaci	[名]
ulgiyada	[形]
ulgiyan	[名]
ulgiyari	[形]
ulhv	[名]
ulhvma	[名]
ulhvmangga	[形]
ulhvri	[形]
ulha	[名]
ulhambi	[及]
ulhi	[名]
ulhibukv	[名]
ulhibumbi	[及]
ulhibun	[名]
ulhicuke	[形]
ulhicun	[名]
ulhicungga	[名]
ulhilembi	[名]
ulhimbi	[及]
ulhin	[名]
ulhingge	[名]
ulhinjembi	[不及]
ulhisu	[名]
ulhisungge	[名]
ulhitun	[名]
ulhiyen	[名]
ulhu	[名]
ulhun	[名]
uli	[名]
ulibumbi	[及][不及]
ulimbi	[及]
ulin	[名]
ulingga	[形]
ulintumbi	[不及]
uliyen	[名]
ulkidun	[名]
ulkume	[名]
ulme	[名]
ulu	[名]
ulu wala	[形][状]
uluken	[形]
ulumbi	[不及]
ulume	[名]
ulun	[名]
ulunembi	[不及]
uluri	[名]
ulusu	[形]
ulusun	[名]
umai	[副]
umainambi	[不及]
uman	[名]
umbuci cimbuci	[状]
umbumbi	[及]
umburi cumburi	[形]
ume	[副]
umehen	[名]
umerlembi	[及]
umesi	[副]
umesihun	[形]
umesilebumbi	[及]
umesilembi	[不及]
umgan	[名]
umhan	[名]
umhangga	[形]
umiyaha	[名]
umiyahalambi	[不及]
umiyahanambi	[不及]
umiyahangge	[名]
umiyelebumbi	[及]
umiyelembi	[及]
umiyesu	[形]
umiyesulembi	[及]
umiyesun	[名]
umpu	[名]
umriha	[名]
umuxuhun	[形]
umudu	[名]
umuhun	[名]
umuri	[名]
umursu	[名]
umusihun	[形]
un	[名]
un xeo	[名]
una	[名]
unagan	[名]
unahan	[名]
uncabumbi	[及]
uncambi	[及]
uncanambi	[及]
uncanjimbi	[及]
uncanumbi	[及]
uncehen	[名]
uncihen	[名]
unda	[名]
undaxambi	[不及]
undan	[名]
undanambi	[不及]
undarambi	[不及]
unde	[形][后]
undehelembi	[及]
undehen	[名]
undesi	[名]
undufun	[名]
undurakv	[名]
undurambi	[不及]
unduri	[方]
undustan	[形]
unenggi	[形]
unenggilembi	[及]
unenggingge	[名]
unenggisaka	[形]
unesi	[名]
ung	[状]
ungga	[名]
unggala	[名]
unggalambi	[及]
unggalamgga	[形]
unggan	[名]
ungganumbi	[及]
unggasahmbi	[及]
ungge	[形]
unggebumbi	[不及]
unggibumbi	[及]
unggilakv	[名]
unggimbi	[及]
unggin	[名]
unggindumbi	[不及]
unggu	[名]
ungkan	[名]
ungkebumbi	[不及]
ungkembi	[及]
ungkemeliyan	[形]
ungken	[形]
ungkeshvn	[形]
unika	[名]
uniyehe	[名]
uniyele	[名]
uniyen	[形]
uniyeri	[名]
untuxembi	[及]
untuhuken	[形]
untuhulebumbi	[及]
untuhulembi	[不及]
untuhun	[形]
untuhungge	[名]
untuhuri	[副]
untuhurilambi	[不及]
untuhusaka	[形]
untun	[名]
unubumbi	[及]
unucun	[名]
unujun	[名]
unumbi	[及]
unun	[名]
unurtu	[名]
upi	[名]
ura	[名]
urahilabumbi	[不及]
urahilambi	[不及]
urakilambi	[不及]
urambi	[不及]
uramib	[不及]
uran	[名]
urandambi	[不及]
urangga	[形]
urantu	[名]
urat	[名]
urebukv	[名]
urebumbi	[及]
urecuke	[形]
urembi	[及][不及]
urenggele	[形]
ureshvn	[形]
urgalabumbi	[及]
urgalambi	[及]
urgan	[名]
urgedemibi	[及]
urgen	[名]
urgesen	[名]
urgetu	[名]
urgucen	[名]
urgulji	[副]
urgumbi	[不及]
urgun	[名]
urgungga	[名]
urgungge	[形]
urgunjebumbi	[及]
urgunjembi	[不及]
urgunjen	[名]
urgunjendumbi	[不及]
urgunjenumbi	[不及]
urguntu	[名]
urhvmbi	[不及]
urhvtu	[名]
urhu	[形]
urhuxembi	[不及]
urhubumbi	[及]
urhulambi	[不及]
urhumbi	[不及]
urhumeliyen	[形]
urhun	[名]
urhuri	[形]
urhutele	[副]
urhutu	[名]
uri	[名]
uribumbi	[及]
uriha	[名]
urilembi	[不及]
urimbi	[不及]
uriyanghai	[名]
urka	[形]
urki	[名]
urkilambi	[不及]
urkilembi	[不及]
urkin	[名]
urkingga	[名]
urkingge	[名]
urkuji	[副]
urkulji	[副]
urlembi	[及]
urlu	[形]
ursa	[名]
ursan	[名]
ursanambi	[不及]
urseingge	[名]
ursu	[名]
ursungga	[形]
uru	[名]
uruxambi	[及]
uruxebumbi	[及]
uruxembi	[及]
urubumbi	[及]
urui	[副]
uruldebumbi	[及]
uruldembi	[不及]
urulembi	[及][不及]
urumbi	[不及]
urumci	[名]
urun	[名]
urunakv	[副]
urundembi	[不及]
urundumbi	[不及]
urunembi	[不及]
usabumbi	[及]
usacuka	[形]
usacumbi	[不及]
usacun	[名]
usacungga	[名]
usambi	[不及]
usambumbi	[及]
usandumbi	[及]
usanumbi	[及]
usari	[形]
usata	[名]
use	[名]
usebumbi	[及]
useku	[名]
uselembi	[及]
usembi	[及]
usen	[名]
usene	[形]
usenembi	[及]
usengge	[形]
usenumbi	[不及]
userci	[名]
useri	[名]
usetu	[形]
ushacun	[名]
ushambi	[不及]
ushandumbi	[不及]
ushanumbi	[不及]
ushatambi	[不及]
ushe	[名]
usi	[形]
usiha	[名]
usihangga	[形]
usihibumbi	[及]
usihiken	[形]
usihimbi	[不及]
usihin	[形]
usihiyambi	[不及]
usihiyan	[形]
usihiyebumbi	[及]
usihiyembi	[及]
usima	[名]
usin	[名]
usintu	[名]
usisi	[名]
usitambi	[及]
usiten	[形]
usucilembi	[及]
usui	[名]
usukan	[形]
usumbi	[不及]
usun	[形]
usurxecuke	[形]
usurxembi	[及]
usuri	[名]
uta	[名]
utala	[代]
utalaka	[代]
utan	[名]
utbala	[名]
uthai	[形][副]
uttu	[副]
uttumbara	[名]
uttungge	[代]
uttusi	[方]
utu	[名]
utulimbi	[不及]
utun	[名]
utung	[名]
uturi	[名]
uyaxambi	[不及]
uyaxan	[名]
uyaxanambi	[不及]
uyaxangga	[形]
uyakan	[形]
uyaljambi	[不及]
uyan	[形][名]
uyancambi	[不及]
uyanjambi	[不及]
uye	[名]
uyebumbi	[及]
uyembi	[及]
uyu	[名]
uyuci	[数]
uyujuci	[数]
uyulembi	[不及]
uyultu	[名]
uyun	[数]
uyungge	[名]
uyunggeri	[数]
uyunju	[数]
uyunjute	[数]
uyuntai	[名]
uyurxambi	[不及]
uyurxembi	[不及]
uyuri	[名]
uyursu	[形]
uyute	[数]
uyutu	[形]
uyutungge	[形]
wa	[名]
waxakv	[名]
waxakta	[形]
waxambi	[及]
wabumbi	[不及]
waburu	[形]
wacan	[名]
wacihiyaxambi	[不及]
wacihiyabumbi	[及]
wacihiyahangge	[形]
wacihiyambi	[及]
wacihiyan	[名]
wacir	[名]
wada	[名]
wadabumbi	[及]
wadambi	[及]
wadan	[名]
wadanambi	[不及]
wadangga	[形]
wahvn	[形]
wahvnda	[名]
wahvtu	[形]
wahai	[副]
wahan	[名]
wahangga	[形]
wahiyabumbi	[及]
wahiyambi	[及]
wai	[名][状]
waidabumbbi	[不及]
waidakv	[名]
waidambi	[及]
waidanambi	[及]
waidanjimbi	[及]
waidanumbi	[及]
waihv	[形]
waihvdambi	[不及]
waihvngga	[名]
waikiyambi	[及]
waiku	[形]
waikurxambi	[不及]
waikurabumbi	[及]
waikurambi	[不及]
wailan	[名]
wainambi	[不及]
waitukv	[名]
wajibumbi	[及]
wajima	[名]
wajimbi	[不及]
wajin	[名]
wajinggala	[后]
wakxan	[名]
waka	[名]
wakaxabumbi	[及]
wakaxambi	[及]
wakalambi	[及]
wakalan	[名]
wakan	[名]
wakiyambi	[及]
wakjahvn	[形]
wakjanambi	[不及]
wala	[方]
walgiyabumbi	[及]
wali	[名]
walingga	[名]
waliyaha	[叹]
waliyambi	[不及]
waliyan	[名]
waliyatai	[后]
walu	[名]
wambi	[及]
wan	[名]
wancarambi	[及]
wanci	[名]
wandumbi	[不及]
wandzy	[名]
wang	[名]
wangga	[形][名]
wangga xangga	[形]
wanggari	[名]
wanggiya	[名]
wanggiyanambi	[不及]
wangkiyaxambi	[及]
wangkiyabumbi	[及]
wangkiyambi	[及]
wangnambi	[及]
wantaha	[名]
wantangga	[形]
wanumbi	[及]
war	[状]
warabumbi	[及]
warambi	[及]
wardaxambi	[不及]
wardabumbi	[及]
wardambi	[及]
wargi	[方]
warka	[名]
warkasi	[名]
waru	[形]
warumbi	[不及]
wasalambi	[不及]
wase	[名]
waselabumbi	[不及]
waselambi	[不及]
waselembi	[不及]
waseri	[形]
washa	[形]
wasibumbi	[及]
wasihvrame	[后]
wasihvun	[方]
wasihaxambi	[及]
wasihalambi	[及]
wasihi	[形]
wasika	[名]
wasimbi	[不及]
wasimbumbi	[及]
wasimeliyan	[形]
wasinambi	[不及]
wasingga	[形]
wasinjimbi	[不及]
wasuri	[形]
watai	[副]
watan	[名]
watangga	[形]
we	[代]
wexen	[名]
wecebumbi	[及]
weceku	[名]
wecembi	[不及]
wecen	[名]
wecesi	[名]
wecingge	[名]
wecu	[形]
wehe	[名]
wehengge	[形]
wehetu	[形]
wehiyen	[名]
wehiyendumbi	[及]
wehiyenumbi	[及]
wehiyetembi	[及]
wei	[名]
wei enduri	[名]
wei ping	[名]
weibin	[名]
weidahvn	[名]
weifutu	[名]
weihe	[名]
weihede	[名]
weihen	[名]
weihengge	[形]
weiherin	[名]
weiheton	[名]
weihu	[名]
weihukelebumbi	[不及]
weihukelembi	[及]
weihuken	[形]
weihun	[形]
weijubumbi	[及]
weijuhen	[名]
weijumbi	[不及]
weijun	[名]
weile	[名]
weilembi	[及]
weilen	[名]
weilendumbi	[不及]
weilenembi	[不及]
weilengge	[形]
weilenjimbi	[不及]
weilenumbi	[不及]
weilumbi	[及]
weingge	[名]
weiping	[名]
weisha	[名]
weisuru	[名]
weji /	[名]
weji	[名]
wekce	[名]
weke	[代]
wekji	[名]
wekjibumbi	[及]
wekjimbi	[及]
welderhen	[名]
welgiyan	[名]
welhvme	[名]
welmiyeku	[名]
welmiyembi	[及]
wembi	[不及]
wembumbi	[及]
wemburi	[名]
wen	[名]
wen wang	[名]
wence	[名]
wencen	[名]
wenceo	[名]
wendeden	[名]
wendembi	[不及]
wenderhen	[名]
wendumbi	[不及]
wenembi	[不及]
wengge	[名]
weniyebumbi	[及]
weniyembi	[不及]
wenje	[名]
wenjehun	[形]
wenjen	[名]
wenjendumbi	[不及]
wenjengge	[形]
wer wer	[状]
werdembi	[及]
werexebumbi	[及]
werexembi	[及]
werebumbi	[及]
werembi	[及]
werembumbi	[及]
weren	[名]
werenebumbi	[不及]
werenembi	[不及]
weri	[代]
weribumbi	[及]
weringge	[名]
werirengge	[形]
werumbi	[不及]
werwen	[名]
wesibun	[名]
wesihulembi	[及]
wesihulen	[名]
wesihun	[形][方]
wesiku	[名]
wesimbi	[不及]
wesimbumbi	[及]
wesinembi	[不及]
wesingge	[形]
wesino	[不及]
yvn	[小]
yvn ban	[名]
yvn hiyang	[名]
yvn nan	[名]
yvn pan	[名]
yvn tong	[名]
ya	[代][名]
ya cing	[形]
ya kumun	[名]
ya me li giya	[名]
ya si ya	[名]
yabxahv	[名]
yabi	[名]
yabilabumbi	[及]
yabsa	[名]
yabsi	[副]
yabubumbi	[及]
yabulan	[名]
yabun	[名]
yabungga	[名]
yabunumbi	[不及]
yaburelambi	[不及]
yaburengge	[名]
yaciha	[名]
yacihiyabumbi	[不及]
yacihiyambi	[不及]
yacikan	[形]
yacike	[名]
yacin	[形]
yacingga	[形]
yacisu	[名]
yadagan	[名]
yadahvxambi	[不及]
yadahvn	[形]
yadali	[形]
yadalinggv	[形]
yadambi	[不及]
yadan	[名]
yadana	[名]
yadarakv	[形]
yafagalambi	[不及]
yafahalabumbi	[及]
yafahalambi	[不及]
yafahan	[形]
yafan	[名]
yafasi	[名]
yagi	[名]
yaha	[名]
yahana	[名]
yahanambi	[不及]
yahari	[名]
yahi	[名]
yahilambi	[及]
yai	[名]
yak	[状]
yakvngga	[形]
yakvnggalambi	[不及]
yaka	[代]
yakajambi	[不及]
yakca	[名]
yaki	[名]
yakilambi	[及]
yaksa	[名]
yaksargan	[名]
yaksigan	[名]
yaksikv	[名]
yaksimbi	[及]
yaksin	[名]
yaksintu	[形]
yaksitai	[副]
yala	[小][副]
yalake	[名]
yaldargan	[名]
yalgan	[名]
yalhv	[名]
yali	[名]
yalici	[名]
yalihangga	[形]
yalihangge	[形]
yalinambi	[不及]
yalingga	[形]
yalitu	[名]
yalmanggi	[名]
yalu	[名]
yalunabumbi	[不及]
yalunambi	[不及]
yalundumbi	[不及]
yalunjimbi	[不及]
yalunumbi	[不及]
yamaka	[形]
yamari	[形]
yambi	[不及]
yamdun	[名]
yamji	[名]
yamjimbi	[不及]
yamjishvn	[形]
yamjitala	[副]
yamka	[形]
yamtari	[名]
yamtun	[名]
yamtungga	[名]
yamulabumbi	[及]
yamulambi	[不及]
yamulanjimbi	[不及]
yamun	[名]
yan	[名]
yan sirge	[名]
yandaci	[名]
yandubumbi	[不及]
yandugan	[形]
yandumbi	[不及]
yang	[名]
yang dze jiyang	[名]
yang ing	[状]
yang sin diyan	[名]
yang yang	[状]
yangxan	[形][名]
yangxangga	[名]
yangxantu	[名]
yangxarambi	[及]
yangduwan	[名]
yanggvha	[名]
yanggvhe	[名]
yanggvwan	[名]
yangga	[名]
yanggaha	[名]
yanggali	[名]
yanggar	[状]
yanggidei	[名]
yanggilabumbi	[不及]
yanggilambi	[及]
yanggilandumbi	[不及]
yanggir	[形]
yanggon	[名]
yangkvnggalambi	[及]
yangkambi	[及]
yangmei	[名]
yangsabumbi	[及]
yangsambi	[及]
yangsanambi	[及]
yangsangga	[形]
yangsanumbi	[及]
yangse	[名]
yangselabumbi	[及]
yangselambi	[及]
yangsembi	[及]
yangsimu	[名]
yangturi	[名]
yar	[状]
yaran	[名]
yarbumbi	[不及]
yardahvn	[名]
yardu	[名]
yarfun	[名]
yarga	[名]
yargaci	[名]
yargican	[形]
yargiyakan	[形]
yargiyalahabi	[不及]
yargiyalambi	[及]
yargiyan	[形]
yargiyangga	[名]
yarhvdai	[名]
yarhvdambi	[及]
yarhvdan	[名]
yarha	[名]
yarhacan	[名]
yarju	[名]
yarkiyambi	[及]
yarkiyan	[名]
yarkiyandumbi	[不及]
yarsi	[名]
yartan	[形]
yaru	[名]
yarubumbi	[不及]
yarudai	[名]
yarugan	[名]
yarukv	[形]
yarumbi	[及]
yarun	[名]
yarungga	[形]
yasa	[名]
yasalabumbi	[不及]
yasalambi	[及]
yasatabumbi	[不及]
yasha	[名]
yashalabumbi	[及]
yashalambi	[及]
yashangga	[形]
yatarabumbi	[及]
yatarakv	[名]
yatarambi	[不及]
yatu	[名]
yatugan	[名]
yatuhan	[名]
yaya	[代]
yayadambi	[不及]
ye	[名]
ye lang	[名]
yebcun	[形]
yebcungge	[形]
yebe	[形]
yebexembi	[及]
yebexeo	[名]
yebecungga	[形]
yebehen	[名]
yebelembi	[及]
yebendembi	[及]
yebkelembi	[及]
yebken	[形]
yebkengge	[名]
yebkesi	[形]
yebsa	[形]
yece	[名]
yecuhe	[名]
yedun	[名]
yehe	[名]
yehengge	[形]
yehere	[名]
yeherengge	[形]
yehetun	[名]
yekembi	[及]
yeken	[名]
yekengge	[形]
yekerxembi	[不及]
yekerakv	[名]
yekse	[名]
yeksergen	[名]
yekserhen	[名]
yelmen	[名]
yelu	[名]
yemji	[名]
yemjiri	[名]
yemjitu	[名]
yen	[名]
yen xeng	[名]
yen du	[名]
yen hing moo	[名]
yendebumbi	[及]
yendebun	[名]
yenden	[名]
yendengge	[形]
yendenumbi	[不及]
yendumbi	[不及]
yenggvhe	[名]
yengge	[名]
yenggehe	[名]
yenggeheri	[形]
yengguhe	[名]
yenghuhe	[名]
yengju	[名]
yengke	[名]
yengsi	[名]
yenmanggi	[名]
yentaha	[名]
yentu	[名]
yerguwe	[名]
yerhe	[名]
yerhuwe	[名]
yerkim	[名]
yerkiyang	[名]
yertexembi	[不及]
yertecuke	[形]
yertecun	[名]
yertembi	[不及]
yeru	[名]
yerutu	[名]
yesoro	[名]
yeye	[形][名]
yeyedembi	[不及]
yo	[名]
yobo	[名]
yobodombi	[及]
yocambi	[不及]
yodambi	[及]
yodan	[名]
yodzana	[名]
yogan	[名]
yoge	[名]
yohan	[名]
yohi	[名]
yohibun	[名]
yohikakv	[及]
yohindambi	[及]
yohingga	[形]
yoho	[名]
yohon	[名]
yohoron	[名]
yohoronombi	[不及]
yojin	[名]
yojohoxombi	[不及]
yojombi	[不及]
yokcin	[名]
yokcingga	[名]
yokidun	[名]
yoktakv	[形]
yokto	[名]
yoktokv	[形]
yolo	[名]
yolo jahvdai	[名]
yoloju	[名]
yolokto	[名]
yolonggi	[名]
yolonggo	[形]
yombi	[不及]
yombumbi	[及]
yonambi	[不及]
yondombi	[不及]
yong	[状]
yonggadun	[形]
yonggaji	[形]
yonggari	[名]
yongge	[名]
yongggan	[名]
yonggor	[状]
yongguci	[名]
yongkiri	[形]
yongkiyabumbi	[及]
yongkiyan	[名]
yongsikv	[名]
yongsu	[名]
yongsunggo	[形]
yongturu	[形]
yoni	[副]
yoo	[名]
yoo di	[名]
yoohan	[名]
yoombi	[不及]
yoonambi	[不及]
yooni	[副]
yooningga	[名]
yoose	[名]
yooselabumbi	[及]
yooselambi	[及]
yor	[状]
yordombi	[及]
yoro	[名]
yose	[名]
yoso	[名]
yoson	[名]
yosonggo	[形]
yoto	[形]
yotokon	[形]
yotombi	[不及]
yoyo	[叹]
yoyohombi	[不及]
yuburxembi	[及]
yukvmbi	[不及]
yukvrxambi	[不及]
yum	[名]
yumKa	[名]
yumbi	[及]
yumbu	[状]
yumbumbi	[不及]
yumggioi	[名]
yumke	[名]
yungturu	[形]
yur	[状]
yurudai	[名]
yurun	[名]
yuryu	[名]
yutu	[名]
yuwamboo	[名]
yuwan	[名]
yuwan aihvma	[名]
yuwan boo	[名]
yuwan bu	[名]
yuwan pan	[名]
yuwanxuwai	[名]
yuwanambi	[不及]
yuwei ba	[名]
yuwei coko	[名]
yuwei cy	[名]
yuwei di	[名]
yuwei ho	[名]
yuwei kin	[名]
yuwei tai	[名]
yuyumbi	[不及]
yuyun	[名]
